time,GB_Pos,GB_Neg,GB_Neu,GB_Total,US_Pos,US_Neg,US_Neu,US_Total,JP_Pos,JP_Neg,JP_Neu,JP_Total
2019-01-07 16:53:00.527000,2,0,0,2,0,0,7,7,0,0,0,0
2019-01-07 16:53:31.875000,0,0,2,2,1,1,1,3,0,0,3,3
2019-01-07 16:53:39.078000,1,0,3,4,2,0,3,5,0,0,0,0
2019-01-07 16:53:45.157000,1,0,3,4,8,0,4,12,1,0,0,1
2019-01-07 16:53:50.599000,1,1,0,2,2,1,2,5,1,0,0,1
2019-01-07 16:53:55.679000,2,0,2,4,4,1,3,8,0,0,0,0
2019-01-07 16:54:01.373000,2,0,0,2,5,1,5,11,0,0,0,0
2019-01-07 16:54:06.492000,1,1,0,2,2,1,2,5,0,0,0,0
2019-01-07 16:54:11.752000,0,1,1,2,5,2,1,8,0,0,0,0
2019-01-07 16:54:16.975000,1,1,1,3,3,0,2,5,0,0,2,2
2019-01-07 16:54:22.176000,1,1,4,6,1,1,4,6,0,0,0,0
2019-01-07 16:54:27.224000,4,1,1,6,9,0,5,14,0,0,2,2
2019-01-07 16:54:33.819000,1,0,0,1,0,1,3,4,0,0,1,1
2019-01-07 16:54:38.952000,1,2,1,4,2,0,4,6,1,0,1,2
2019-01-07 16:54:44.435000,1,1,1,3,1,2,5,8,0,0,0,0
2019-01-07 16:54:49.658000,2,1,1,4,3,0,3,6,0,0,1,1
2019-01-07 16:54:57.862000,2,1,2,5,3,1,2,6,0,0,1,1
2019-01-07 16:55:03.268000,1,0,2,3,0,0,5,5,0,0,0,0
2019-01-07 16:55:08.700000,0,1,1,2,4,1,4,9,0,0,0,0
2019-01-07 16:55:14.548000,4,0,3,7,1,1,1,3,0,0,2,2
2019-01-07 16:55:20.304000,2,0,0,2,6,1,2,9,0,0,2,2
2019-01-07 16:55:25.773000,1,0,0,1,1,0,1,2,0,0,1,1
2019-01-07 16:55:31.049000,1,0,2,3,2,0,0,2,0,0,2,2
2019-01-07 16:55:36.063000,4,2,6,12,3,1,0,4,0,0,1,1
2019-01-07 16:55:41.388000,2,0,2,4,1,0,5,6,0,0,1,1
2019-01-07 16:55:46.696000,4,1,2,7,0,1,1,2,0,0,2,2
2019-01-07 16:55:52.586000,1,0,1,2,2,1,1,4,0,0,1,1
2019-01-07 16:55:58.445000,0,0,2,2,4,1,5,10,0,0,2,2
2019-01-07 16:56:04.126000,2,1,0,3,4,1,2,7,0,0,4,4
2019-01-07 16:56:09.590000,0,0,0,0,3,0,5,8,0,0,0,0
2019-01-07 16:56:14.938000,1,1,1,3,2,0,2,4,0,0,0,0
2019-01-07 16:56:20.035000,1,0,2,3,2,0,3,5,0,0,2,2
2019-01-07 16:56:25.039000,0,1,2,3,2,0,2,4,0,0,3,3
2019-01-07 16:56:30.622000,0,0,0,0,5,0,4,9,0,0,2,2
2019-01-07 16:56:35.638000,1,0,1,2,2,0,3,5,0,0,0,0
2019-01-07 16:56:42.766000,1,2,2,5,2,0,4,6,0,0,0,0
2019-01-07 16:56:48.238000,2,1,2,5,6,1,1,8,0,0,1,1
2019-01-07 16:56:54.482000,1,0,3,4,2,3,5,10,0,0,1,1
2019-01-07 16:56:59.821000,0,0,4,4,1,0,4,5,0,0,3,3
2019-01-07 16:57:04.910000,4,1,0,5,2,3,5,10,0,0,2,2
2019-01-07 16:57:10.814000,1,0,2,3,1,1,4,6,0,0,1,1
2019-01-07 16:57:16.508000,2,1,0,3,4,2,4,10,0,0,1,1
2019-01-07 16:57:21.869000,2,1,3,6,3,2,2,7,0,0,2,2
2019-01-07 16:57:26.939000,2,0,5,7,2,0,8,10,0,0,1,1
2019-01-07 16:57:32.788000,0,0,2,2,4,0,2,6,0,0,1,1
2019-01-07 16:57:37.868000,1,1,1,3,3,1,6,10,0,0,1,1
2019-01-07 16:57:43.360000,3,0,3,6,4,0,5,9,0,0,2,2
2019-01-07 16:57:48.454000,1,0,0,1,1,1,4,6,0,0,0,0
2019-01-07 16:57:53.538000,2,0,2,4,0,0,4,4,0,0,2,2
2019-01-07 16:57:59.049000,1,1,2,4,3,0,0,3,0,0,0,0
2019-01-07 16:58:04.240000,4,0,2,6,2,1,3,6,0,0,1,1
2019-01-07 16:58:09.971000,0,0,1,1,2,1,2,5,0,0,3,3
2019-01-07 16:58:15.024000,0,0,1,1,4,3,2,9,0,0,2,2
2019-01-07 16:58:20.166000,0,1,7,8,1,0,4,5,0,0,1,1
2019-01-07 16:58:25.751000,1,1,1,3,3,0,5,8,0,0,1,1
2019-01-07 16:58:30.754000,2,0,4,6,4,2,2,8,0,0,3,3
2019-01-07 16:58:35.877000,0,1,4,5,4,0,2,6,0,0,1,1
2019-01-07 16:58:41.254000,0,2,3,5,1,3,5,9,0,0,1,1
2019-01-07 16:58:46.441000,1,0,1,2,3,0,2,5,0,0,2,2
2019-01-07 16:58:51.516000,1,0,1,2,1,1,1,3,0,0,1,1
2019-01-07 16:58:56.530000,3,1,3,7,2,0,1,3,0,0,2,2
2019-01-07 16:59:01.712000,2,0,2,4,0,1,1,2,1,0,0,1
2019-01-07 16:59:06.807000,2,2,2,6,2,1,3,6,0,0,1,1
2019-01-07 16:59:12.272000,1,2,3,6,6,0,2,8,0,0,0,0
2019-01-07 16:59:17.589000,1,1,1,3,2,0,5,7,0,0,1,1
2019-01-07 16:59:22.613000,2,1,3,6,5,0,3,8,0,0,0,0
2019-01-07 16:59:27.618000,3,0,1,4,1,2,6,9,0,0,2,2
2019-01-07 16:59:33.378000,1,1,5,7,2,0,4,6,0,0,0,0
2019-01-07 16:59:39.285000,3,1,3,7,2,0,3,5,0,0,2,2
2019-01-07 16:59:44.739000,5,1,6,12,5,2,4,11,0,0,0,0
2019-01-07 16:59:49.928000,0,0,0,0,1,4,8,13,0,0,1,1
2019-01-07 16:59:55.171000,3,0,1,4,1,1,5,7,0,0,0,0
2019-01-07 17:00:00.274000,3,0,4,7,1,0,3,4,0,0,6,6
2019-01-07 17:00:05.379000,1,0,4,5,2,1,1,4,0,0,2,2
2019-01-07 17:00:10.420000,3,0,5,8,2,0,4,6,0,0,0,0
2019-01-07 17:00:15.616000,2,0,4,6,5,1,5,11,0,0,0,0
2019-01-07 17:00:20.826000,2,1,4,7,1,1,5,7,0,0,1,1
2019-01-07 17:00:26.020000,1,1,2,4,4,1,6,11,0,0,0,0
2019-01-07 17:00:31.120000,0,1,2,3,0,0,5,5,0,0,0,0
2019-01-07 17:00:36.990000,0,1,3,4,1,2,6,9,0,0,2,2
2019-01-07 17:00:42.236000,1,1,4,6,3,0,3,6,0,0,0,0
2019-01-07 17:00:47.403000,0,0,3,3,3,2,5,10,0,0,3,3
2019-01-07 17:00:52.978000,0,1,1,2,4,2,1,7,0,0,0,0
2019-01-07 17:00:58.036000,1,0,2,3,2,0,3,5,0,0,3,3
2019-01-07 17:01:03.208000,4,0,4,8,4,2,2,8,0,0,1,1
2019-01-07 17:01:08.482000,2,1,0,3,3,1,1,5,0,0,1,1
2019-01-07 17:01:13.972000,0,0,5,5,1,0,8,9,1,0,1,2
2019-01-07 17:01:19.132000,1,2,1,4,3,2,0,5,1,0,0,1
2019-01-07 17:01:26.044000,1,0,0,1,2,0,10,12,0,0,0,0
2019-01-07 17:01:31.090000,4,0,1,5,3,0,6,9,0,0,1,1
2019-01-07 17:01:36.122000,0,2,3,5,2,1,4,7,0,0,6,6
2019-01-07 17:01:41.394000,0,0,1,1,1,2,4,7,0,0,5,5
2019-01-07 17:01:46.624000,1,2,1,4,1,0,3,4,0,0,1,1
2019-01-07 17:01:52.438000,2,1,0,3,3,1,4,8,0,0,2,2
2019-01-07 17:01:57.536000,1,0,3,4,2,3,4,9,0,0,1,1
2019-01-07 17:02:02.781000,0,0,4,4,1,4,2,7,0,0,0,0
2019-01-07 17:02:07.857000,2,0,2,4,8,2,2,12,0,0,0,0
2019-01-07 17:02:13.485000,0,1,2,3,1,1,1,3,0,0,1,1
2019-01-07 17:02:18.539000,0,0,0,0,2,0,6,8,0,0,1,1
2019-01-07 17:02:24.303000,1,1,2,4,3,1,1,5,0,0,2,2
2019-01-07 17:02:29.402000,4,4,2,10,3,0,8,11,0,0,1,1
2019-01-07 17:02:34.646000,0,1,3,4,2,4,5,11,0,0,2,2
2019-01-07 17:02:39.773000,0,0,0,0,4,1,4,9,0,0,0,0
2019-01-07 17:02:45.071000,4,0,1,5,1,0,2,3,0,0,1,1
2019-01-07 17:02:50.083000,4,0,5,9,1,2,6,9,0,0,0,0
2019-01-07 17:02:55.543000,0,0,3,3,3,0,3,6,0,0,3,3
2019-01-07 17:03:00.561000,1,0,2,3,2,1,2,5,0,0,3,3
2019-01-07 17:03:05.636000,1,1,2,4,3,1,1,5,0,0,2,2
2019-01-07 17:03:10.972000,1,0,0,1,4,0,3,7,0,0,2,2
2019-01-07 17:03:16.645000,7,0,2,9,3,2,0,5,0,0,1,1
2019-01-07 17:03:21.910000,2,1,2,5,4,1,1,6,0,0,1,1
2019-01-07 17:03:27.159000,0,0,0,0,3,2,2,7,0,0,0,0
2019-01-07 17:03:32.736000,1,0,1,2,11,2,5,18,0,0,0,0
2019-01-07 17:03:37.888000,1,2,1,4,5,3,5,13,0,0,0,0
2019-01-07 17:03:43.056000,2,0,0,2,6,2,4,12,0,0,2,2
2019-01-07 17:03:49.196000,1,0,1,2,3,0,3,6,0,0,1,1
2019-01-07 17:03:54.198000,1,0,4,5,1,1,2,4,0,0,0,0
2019-01-07 17:03:59.342000,4,1,1,6,0,0,5,5,0,0,3,3
2019-01-07 17:04:04.686000,1,2,5,8,5,0,2,7,0,0,2,2
2019-01-07 17:04:09.749000,1,0,0,1,3,0,5,8,1,0,1,2
2019-01-07 17:04:15.022000,0,0,0,0,4,1,3,8,0,0,2,2
2019-01-07 17:04:20.310000,3,0,5,8,1,3,1,5,0,0,6,6
2019-01-07 17:04:25.484000,1,2,1,4,3,1,5,9,0,0,0,0
2019-01-07 17:04:30.552000,1,2,1,4,3,0,3,6,0,0,1,1
2019-01-07 17:04:36.842000,2,2,1,5,1,1,5,7,0,0,2,2
2019-01-07 17:04:43.140000,1,0,3,4,5,1,4,10,0,0,0,0
2019-01-07 17:04:48.389000,2,0,2,4,2,0,6,8,0,0,0,0
2019-01-07 17:04:53.621000,1,0,4,5,1,1,3,5,0,0,1,1
2019-01-07 17:04:59.779000,2,0,4,6,2,1,6,9,0,0,2,2
2019-01-07 17:05:05.851000,2,0,1,3,1,0,5,6,0,0,1,1
2019-01-07 17:05:11.005000,1,0,0,1,3,1,4,8,1,0,1,2
2019-01-07 17:05:16.206000,1,1,1,3,4,1,2,7,0,0,6,6
2019-01-07 17:05:21.413000,1,0,4,5,2,3,4,9,0,0,0,0
2019-01-07 17:05:26.949000,1,0,0,1,2,0,5,7,0,0,2,2
2019-01-07 17:05:32.569000,3,0,2,5,2,1,1,4,0,0,1,1
2019-01-07 17:05:37.638000,2,2,2,6,2,1,5,8,0,0,0,0
2019-01-07 17:05:42.663000,0,0,3,3,0,0,4,4,0,0,1,1
2019-01-07 17:05:47.951000,0,1,4,5,1,1,2,4,0,0,4,4
2019-01-07 17:05:53.401000,1,0,1,2,1,1,6,8,0,0,2,2
2019-01-07 17:05:59.020000,1,1,1,3,3,0,1,4,0,0,1,1
2019-01-07 17:06:04.516000,5,0,2,7,1,0,4,5,0,0,1,1
2019-01-07 17:06:09.525000,2,0,1,3,2,1,7,10,0,0,1,1
2019-01-07 17:06:14.865000,2,2,3,7,4,0,4,8,0,0,1,1
2019-01-07 17:06:20.988000,1,0,3,4,3,1,2,6,0,0,2,2
2019-01-07 17:06:26.301000,0,0,1,1,1,2,2,5,0,0,2,2
2019-01-07 17:06:31.500000,2,0,3,5,1,1,4,6,0,0,0,0
2019-01-07 17:06:36.673000,1,1,3,5,3,2,4,9,0,0,1,1
2019-01-07 17:06:41.730000,1,1,1,3,5,0,6,11,0,0,1,1
2019-01-07 17:06:47.154000,1,0,2,3,1,0,2,3,0,0,0,0
2019-01-07 17:06:52.161000,1,0,0,1,2,0,5,7,0,0,1,1
2019-01-07 17:06:58.131000,3,1,2,6,2,2,5,9,0,0,1,1
2019-01-07 17:07:03.375000,3,0,3,6,2,1,3,6,0,0,1,1
2019-01-07 17:07:08.639000,1,0,1,2,2,1,3,6,0,0,1,1
2019-01-07 17:07:13.765000,0,0,2,2,1,1,2,4,0,0,1,1
2019-01-07 17:07:18.930000,0,1,1,2,3,0,1,4,0,0,0,0
2019-01-07 17:07:24.772000,2,0,2,4,4,2,5,11,0,0,1,1
2019-01-07 17:07:29.877000,1,0,3,4,1,2,4,7,0,0,1,1
2019-01-07 17:07:35.120000,2,0,0,2,2,2,3,7,0,0,2,2
2019-01-07 17:07:40.251000,1,0,5,6,4,1,1,6,0,0,2,2
2019-01-07 17:07:45.820000,1,1,1,3,2,0,0,2,0,0,1,1
2019-01-07 17:07:51.273000,1,1,2,4,3,0,5,8,0,0,1,1
2019-01-07 17:07:56.274000,0,0,2,2,1,0,1,2,0,0,1,1
2019-01-07 17:08:01.714000,2,0,0,2,1,0,5,6,0,0,2,2
2019-01-07 17:08:07.473000,1,1,0,2,2,0,4,6,0,0,0,0
2019-01-07 17:08:13.083000,3,0,1,4,4,0,3,7,0,0,0,0
2019-01-07 17:08:18.188000,3,1,1,5,6,0,5,11,0,0,1,1
2019-01-07 17:08:24.464000,2,0,2,4,1,0,2,3,0,0,3,3
2019-01-07 17:08:29.527000,1,0,1,2,1,0,3,4,0,0,1,1
2019-01-07 17:08:34.598000,3,1,6,10,1,0,2,3,0,0,1,1
2019-01-07 17:08:39.846000,2,0,1,3,3,1,4,8,0,0,1,1
2019-01-07 17:08:45.480000,3,2,0,5,4,0,4,8,0,0,0,0
2019-01-07 17:08:50.856000,2,0,4,6,3,0,2,5,0,0,0,0
2019-01-07 17:08:56.652000,0,1,1,2,1,1,1,3,0,0,0,0
2019-01-07 17:09:02.097000,1,2,0,3,0,2,1,3,0,0,2,2
2019-01-07 17:09:07.634000,0,0,2,2,3,1,4,8,0,0,2,2
2019-01-07 17:09:13.012000,2,0,2,4,1,1,3,5,0,0,1,1
2019-01-07 17:09:18.228000,2,1,3,6,2,0,2,4,0,0,1,1
2019-01-07 17:09:23.724000,6,0,0,6,0,0,3,3,0,0,1,1
2019-01-07 17:09:29.306000,1,0,4,5,3,2,4,9,0,0,0,0
2019-01-07 17:09:34.538000,0,1,3,4,1,1,2,4,0,0,2,2
2019-01-07 17:09:39.970000,0,1,2,3,0,2,1,3,0,0,0,0
2019-01-07 17:09:45.383000,3,1,4,8,3,3,3,9,0,0,2,2
2019-01-07 17:09:51.986000,5,0,2,7,4,1,5,10,0,0,3,3
2019-01-07 17:09:57.372000,5,0,1,6,6,1,1,8,0,0,2,2
2019-01-07 17:10:02.549000,2,0,2,4,4,2,1,7,1,0,0,1
2019-01-07 17:10:07.747000,2,2,2,6,4,0,1,5,0,0,1,1
2019-01-07 17:10:13.272000,2,0,3,5,5,2,1,8,0,0,0,0
2019-01-07 17:10:18.536000,0,2,1,3,0,0,1,1,0,0,1,1
2019-01-07 17:10:23.900000,1,0,1,2,3,1,8,12,0,0,2,2
2019-01-07 17:10:29.074000,1,2,2,5,3,0,1,4,0,0,0,0
2019-01-07 17:10:34.929000,0,1,1,2,1,0,3,4,0,0,4,4
2019-01-07 17:10:40.765000,1,1,1,3,2,1,1,4,0,0,4,4
2019-01-07 17:10:45.940000,4,0,3,7,3,0,4,7,0,0,0,0
2019-01-07 17:10:51.149000,1,0,3,4,5,1,4,10,0,0,0,0
2019-01-07 17:10:56.336000,3,0,0,3,1,0,4,5,0,0,3,3
2019-01-07 17:11:03.010000,4,2,1,7,4,1,1,6,0,0,0,0
2019-01-07 17:11:08.691000,0,0,2,2,3,1,6,10,0,0,0,0
2019-01-07 17:11:13.799000,2,0,0,2,3,0,4,7,0,0,2,2
2019-01-07 17:11:18.894000,2,0,4,6,2,4,3,9,0,0,2,2
2019-01-07 17:11:24.150000,4,0,1,5,3,1,5,9,0,0,0,0
2019-01-07 17:11:29.187000,2,1,3,6,1,0,6,7,0,0,0,0
2019-01-07 17:11:34.305000,5,0,7,12,2,1,3,6,0,0,0,0
2019-01-07 17:11:39.905000,0,0,5,5,1,1,5,7,1,0,1,2
2019-01-07 17:11:45.092000,2,0,2,4,4,1,2,7,0,0,1,1
2019-01-07 17:11:50.180000,1,0,3,4,5,2,2,9,0,0,0,0
2019-01-07 17:11:55.687000,4,2,0,6,4,1,2,7,0,0,0,0
2019-01-07 17:12:01.033000,1,1,5,7,2,1,4,7,0,0,1,1
2019-01-07 17:12:06.297000,1,0,5,6,1,2,5,8,0,0,3,3
2019-01-07 17:12:11.507000,1,0,1,2,4,1,3,8,2,0,1,3
2019-01-07 17:12:16.625000,0,1,6,7,1,0,1,2,0,0,1,1
2019-01-07 17:12:21.634000,3,0,2,5,1,0,2,3,0,0,0,0
2019-01-07 17:12:26.728000,0,0,3,3,2,1,1,4,0,0,1,1
2019-01-07 17:12:31.752000,1,0,1,2,4,2,2,8,0,0,0,0
2019-01-07 17:12:37.412000,1,0,3,4,1,0,3,4,0,0,3,3
2019-01-07 17:12:42.564000,0,0,2,2,0,0,2,2,0,0,3,3
2019-01-07 17:12:47.803000,3,0,3,6,4,3,4,11,0,0,1,1
2019-01-07 17:12:53.011000,2,1,0,3,3,0,5,8,1,0,3,4
2019-01-07 17:12:58.403000,0,1,2,3,2,0,7,9,0,0,3,3
2019-01-07 17:13:03.764000,0,0,1,1,3,1,7,11,0,0,5,5
2019-01-07 17:13:09.426000,2,1,3,6,2,2,4,8,0,0,2,2
2019-01-07 17:13:14.690000,1,1,3,5,3,0,3,6,0,1,1,2
2019-01-07 17:13:19.714000,1,0,4,5,1,1,7,9,0,0,1,1
2019-01-07 17:13:25.154000,0,0,4,4,1,2,2,5,0,0,1,1
2019-01-07 17:13:30.686000,2,0,4,6,2,4,4,10,0,0,4,4
2019-01-07 17:13:35.811000,1,1,1,3,1,0,5,6,0,0,2,2
2019-01-07 17:13:41.108000,3,1,4,8,3,1,2,6,0,0,1,1
2019-01-07 17:13:46.168000,1,2,5,8,2,2,3,7,0,0,0,0
2019-01-07 17:13:51.527000,0,1,2,3,1,3,4,8,0,0,1,1
2019-01-07 17:13:57.088000,3,0,3,6,1,1,3,5,0,0,0,0
2019-01-07 17:14:02.122000,0,1,4,5,4,0,3,7,0,0,2,2
2019-01-07 17:14:07.614000,2,1,1,4,3,1,3,7,0,0,1,1
2019-01-07 17:14:13.413000,1,1,2,4,6,0,3,9,0,0,4,4
2019-01-07 17:14:19.007000,2,2,2,6,5,0,4,9,0,0,1,1
2019-01-07 17:14:25.428000,1,0,3,4,1,0,4,5,0,0,2,2
2019-01-07 17:14:31.713000,2,0,0,2,5,1,0,6,0,1,2,3
2019-01-07 17:14:36.772000,1,0,4,5,2,0,3,5,0,0,0,0
2019-01-07 17:14:41.855000,1,0,1,2,4,2,3,9,0,0,1,1
2019-01-07 17:14:47.008000,1,1,4,6,2,0,3,5,0,0,0,0
2019-01-07 17:14:52.404000,2,0,2,4,0,1,0,1,0,0,2,2
2019-01-07 17:14:57.947000,0,1,1,2,1,1,3,5,0,0,1,1
2019-01-07 17:15:04.195000,2,0,3,5,2,1,0,3,0,0,1,1
2019-01-07 17:15:10.225000,1,0,1,2,2,1,3,6,0,0,0,0
2019-01-07 17:15:15.804000,2,0,1,3,2,1,3,6,0,0,1,1
2019-01-07 17:15:21.286000,2,1,3,6,4,1,3,8,0,0,1,1
2019-01-07 17:15:27.116000,1,0,1,2,3,0,6,9,0,0,1,1
2019-01-07 17:15:32.142000,0,0,3,3,2,0,2,4,0,0,1,1
2019-01-07 17:15:37.272000,1,1,4,6,3,0,2,5,0,0,0,0
2019-01-07 17:15:42.767000,1,3,2,6,1,0,2,3,1,0,4,5
2019-01-07 17:15:47.908000,2,0,3,5,5,3,6,14,0,0,1,1
2019-01-07 17:15:52.917000,2,2,3,7,4,1,5,10,0,0,2,2
2019-01-07 17:15:58.232000,0,2,0,2,1,2,5,8,0,0,3,3
2019-01-07 17:16:03.854000,0,2,2,4,3,1,5,9,0,0,2,2
2019-01-07 17:16:08.861000,1,1,4,6,2,3,3,8,0,0,2,2
2019-01-07 17:16:13.959000,2,0,0,2,1,0,4,5,0,0,3,3
2019-01-07 17:16:19.766000,1,0,3,4,6,0,6,12,0,0,0,0
2019-01-07 17:16:24.878000,0,2,0,2,1,0,5,6,0,0,0,0
2019-01-07 17:16:30.226000,0,0,4,4,4,0,1,5,0,0,0,0
2019-01-07 17:16:35.398000,2,0,1,3,2,2,3,7,0,0,3,3
2019-01-07 17:16:41.124000,2,1,2,5,1,3,4,8,0,0,0,0
2019-01-07 17:16:46.353000,0,0,1,1,1,1,3,5,0,0,1,1
2019-01-07 17:16:51.526000,3,1,0,4,4,2,1,7,1,0,2,3
2019-01-07 17:16:57.072000,2,0,3,5,1,1,4,6,0,0,1,1
2019-01-07 17:17:02.412000,3,0,0,3,2,0,4,6,0,0,1,1
2019-01-07 17:17:07.420000,2,0,0,2,3,2,4,9,0,0,1,1
2019-01-07 17:17:12.499000,0,1,2,3,3,0,2,5,0,0,0,0
2019-01-07 17:17:17.753000,1,0,0,1,1,0,4,5,0,0,1,1
2019-01-07 17:17:22.765000,1,1,1,3,2,1,6,9,0,0,0,0
2019-01-07 17:17:30.533000,0,0,2,2,3,1,6,10,0,0,5,5
2019-01-07 17:17:36.132000,1,0,1,2,4,0,3,7,1,0,3,4
2019-01-07 17:17:41.876000,0,1,0,1,3,0,0,3,0,0,1,1
2019-01-07 17:17:47.030000,1,0,3,4,2,1,8,11,0,0,4,4
2019-01-07 17:17:52.523000,1,0,2,3,2,3,4,9,0,0,1,1
2019-01-07 17:17:57.819000,4,0,2,6,2,1,3,6,0,0,2,2
2019-01-07 17:18:02.948000,0,0,1,1,3,0,4,7,1,0,0,1
2019-01-07 17:18:08.033000,2,0,3,5,4,1,2,7,0,0,0,0
2019-01-07 17:18:13.639000,2,2,3,7,4,0,3,7,0,0,2,2
2019-01-07 17:18:18.865000,2,0,0,2,2,0,2,4,0,0,1,1
2019-01-07 17:18:24.307000,1,2,0,3,5,1,2,8,0,0,1,1
2019-01-07 17:18:29.538000,1,1,3,5,0,0,6,6,0,0,2,2
2019-01-07 17:18:34.649000,1,1,4,6,4,1,7,12,0,0,3,3
2019-01-07 17:18:40.019000,2,2,2,6,3,1,1,5,0,0,2,2
2019-01-07 17:18:45.027000,1,0,1,2,3,0,5,8,0,0,1,1
2019-01-07 17:18:50.213000,0,0,1,1,2,2,3,7,0,0,2,2
2019-01-07 17:18:56.579000,3,1,1,5,4,0,3,7,0,0,1,1
2019-01-07 17:19:02.252000,4,1,0,5,5,1,2,8,0,0,0,0
2019-01-07 17:19:07.408000,1,1,1,3,3,1,5,9,0,0,0,0
2019-01-07 17:19:13.058000,2,1,4,7,0,2,1,3,0,0,2,2
2019-01-07 17:19:18.223000,0,3,1,4,1,1,7,9,1,0,2,3
2019-01-07 17:19:23.341000,1,0,2,3,1,1,2,4,0,0,0,0
2019-01-07 17:19:28.756000,2,1,5,8,3,2,4,9,0,0,0,0
2019-01-07 17:19:33.760000,1,0,3,4,5,0,7,12,0,0,1,1
2019-01-07 17:19:38.894000,2,0,2,4,2,0,5,7,0,0,1,1
2019-01-07 17:19:44.507000,1,0,5,6,1,1,6,8,0,0,2,2
2019-01-07 17:19:49.626000,0,1,3,4,2,0,4,6,0,0,1,1
2019-01-07 17:19:54.642000,1,1,1,3,1,2,2,5,1,0,0,1
2019-01-07 17:19:59.805000,2,0,2,4,5,0,6,11,0,0,2,2
2019-01-07 17:20:04.811000,4,0,3,7,3,1,5,9,0,0,0,0
2019-01-07 17:20:09.965000,1,0,6,7,4,1,1,6,0,0,2,2
2019-01-07 17:20:15.181000,1,0,2,3,1,1,2,4,0,0,3,3
2019-01-07 17:20:20.645000,2,0,2,4,3,0,3,6,0,0,2,2
2019-01-07 17:20:25.675000,2,0,1,3,1,1,4,6,0,0,5,5
2019-01-07 17:20:30.762000,1,1,0,2,1,3,2,6,0,0,2,2
2019-01-07 17:20:35.957000,1,1,2,4,2,1,4,7,0,0,2,2
2019-01-07 17:20:41.203000,0,0,4,4,3,1,2,6,0,0,1,1
2019-01-07 17:20:47.665000,0,1,3,4,5,0,0,5,1,0,1,2
2019-01-07 17:20:52.884000,1,0,4,5,1,1,2,4,0,0,2,2
2019-01-07 17:20:57.926000,2,1,2,5,1,2,5,8,0,0,2,2
2019-01-07 17:21:02.970000,0,0,0,0,2,3,2,7,0,0,1,1
2019-01-07 17:21:08.573000,1,1,4,6,1,1,6,8,1,0,4,5
2019-01-07 17:21:13.692000,1,0,1,2,4,1,2,7,0,0,1,1
2019-01-07 17:21:19.198000,1,0,2,3,3,0,5,8,0,0,2,2
2019-01-07 17:21:25.064000,1,2,3,6,6,0,2,8,0,0,2,2
2019-01-07 17:21:30.301000,3,0,3,6,2,0,3,5,0,0,2,2
2019-01-07 17:21:35.734000,2,0,3,5,1,1,5,7,0,0,0,0
2019-01-07 17:21:42.599000,2,1,0,3,3,2,1,6,0,1,0,1
2019-01-07 17:21:47.693000,1,0,2,3,2,0,3,5,0,0,1,1
2019-01-07 17:21:53.014000,3,0,1,4,1,4,2,7,0,0,3,3
2019-01-07 17:21:58.234000,4,0,2,6,3,0,3,6,0,0,2,2
2019-01-07 17:22:03.429000,0,0,1,1,5,4,6,15,0,0,2,2
2019-01-07 17:22:11.066000,1,0,1,2,2,0,3,5,0,0,2,2
2019-01-07 17:22:18.061000,2,1,1,4,5,2,2,9,1,1,0,2
2019-01-07 17:22:23.805000,3,1,1,5,1,0,5,6,0,0,0,0
2019-01-07 17:22:29.163000,3,1,3,7,2,1,1,4,0,0,3,3
2019-01-07 17:22:35.850000,3,1,0,4,2,0,4,6,0,0,0,0
2019-01-07 17:22:40.928000,0,0,1,1,2,1,3,6,0,0,1,1
2019-01-07 17:22:46.242000,0,1,2,3,3,0,3,6,0,0,3,3
2019-01-07 17:22:51.359000,2,0,3,5,2,0,5,7,0,0,2,2
2019-01-07 17:22:56.657000,1,0,1,2,3,1,1,5,0,0,1,1
2019-01-07 17:23:02.310000,0,0,3,3,2,1,2,5,0,0,1,1
2019-01-07 17:23:07.597000,2,1,1,4,2,3,1,6,0,0,0,0
2019-01-07 17:23:12.719000,1,2,1,4,3,1,6,10,0,0,2,2
2019-01-07 17:23:18.101000,0,0,3,3,1,0,5,6,0,0,1,1
2019-01-07 17:23:23.768000,2,0,3,5,2,0,1,3,0,0,1,1
2019-01-07 17:23:29.259000,1,1,0,2,3,0,2,5,1,0,3,4
2019-01-07 17:23:34.754000,3,0,1,4,0,1,2,3,0,0,1,1
2019-01-07 17:23:39.855000,1,1,2,4,1,1,3,5,0,0,0,0
2019-01-07 17:23:45.521000,2,0,6,8,2,1,2,5,0,0,1,1
2019-01-07 17:23:51.623000,3,1,2,6,2,0,4,6,0,0,5,5
2019-01-07 17:23:57.375000,2,0,2,4,1,0,5,6,0,0,0,0
2019-01-07 17:24:02.395000,2,0,5,7,1,1,4,6,0,0,3,3
2019-01-07 17:24:07.464000,2,2,1,5,0,0,4,4,0,0,1,1
2019-01-07 17:24:12.705000,2,0,0,2,1,0,4,5,0,0,2,2
2019-01-07 17:24:17.854000,0,0,1,1,2,1,2,5,0,0,0,0
2019-01-07 17:24:23.203000,1,1,3,5,4,1,2,7,0,0,1,1
2019-01-07 17:24:28.265000,0,1,2,3,1,1,3,5,0,0,1,1
2019-01-07 17:24:33.863000,1,0,5,6,1,0,2,3,0,0,3,3
2019-01-07 17:24:39.154000,3,0,5,8,3,1,5,9,0,0,0,0
2019-01-07 17:24:44.326000,1,0,2,3,1,0,2,3,0,0,2,2
2019-01-07 17:24:50.007000,3,0,2,5,2,0,3,5,0,0,0,0
2019-01-07 17:24:55.119000,1,2,2,5,1,0,3,4,0,0,3,3
2019-01-07 17:25:00.384000,0,1,4,5,1,2,5,8,0,0,3,3
2019-01-07 17:25:06.829000,1,0,3,4,4,1,4,9,0,0,1,1
2019-01-07 17:25:12.120000,2,0,5,7,1,0,4,5,0,0,0,0
2019-01-07 17:25:17.149000,0,0,0,0,2,0,5,7,0,0,1,1
2019-01-07 17:25:22.259000,1,0,4,5,2,1,3,6,0,0,1,1
2019-01-07 17:25:27.518000,1,1,2,4,2,0,2,4,0,0,1,1
2019-01-07 17:25:34.824000,1,1,1,3,3,0,4,7,0,0,0,0
2019-01-07 17:25:40.124000,2,0,3,5,1,0,4,5,0,1,2,3
2019-01-07 17:25:45.333000,2,0,1,3,2,1,2,5,0,0,2,2
2019-01-07 17:25:50.839000,2,0,1,3,2,0,1,3,0,0,1,1
2019-01-07 17:25:56.174000,4,0,1,5,4,1,3,8,0,0,1,1
2019-01-07 17:26:01.452000,1,3,1,5,4,1,2,7,0,0,0,0
2019-01-07 17:26:06.551000,2,0,2,4,5,2,4,11,0,0,1,1
2019-01-07 17:26:11.993000,2,0,2,4,1,1,5,7,0,0,0,0
2019-01-07 17:26:17.168000,2,0,1,3,2,0,2,4,0,0,1,1
2019-01-07 17:26:22.718000,4,0,0,4,1,0,3,4,0,0,0,0
2019-01-07 17:26:27.997000,4,1,0,5,2,1,3,6,0,0,0,0
2019-01-07 17:26:33.014000,0,0,2,2,1,1,3,5,0,1,1,2
2019-01-07 17:26:38.617000,3,1,2,6,1,3,1,5,0,0,0,0
2019-01-07 17:26:44.620000,0,2,3,5,3,1,3,7,0,0,1,1
2019-01-07 17:26:49.843000,1,0,1,2,1,1,4,6,0,0,1,1
2019-01-07 17:26:54.884000,0,0,1,1,0,2,2,4,0,0,2,2
2019-01-07 17:27:00.707000,3,0,0,3,2,0,4,6,0,0,1,1
2019-01-07 17:27:05.747000,1,0,3,4,3,2,4,9,0,0,1,1
2019-01-07 17:27:11.079000,0,0,1,1,3,1,2,6,0,0,0,0
2019-01-07 17:27:16.140000,1,1,2,4,3,1,2,6,0,0,1,1
2019-01-07 17:27:22.689000,2,0,1,3,4,1,7,12,0,0,1,1
2019-01-07 17:27:27.924000,2,1,1,4,2,0,5,7,0,0,2,2
2019-01-07 17:27:33.176000,1,0,3,4,0,3,4,7,0,0,2,2
2019-01-07 17:27:38.725000,1,1,3,5,2,2,6,10,0,0,0,0
2019-01-07 17:27:43.792000,2,1,3,6,2,1,2,5,0,0,0,0
2019-01-07 17:27:48.908000,2,0,1,3,5,0,9,14,0,0,0,0
2019-01-07 17:27:54.588000,1,0,2,3,3,1,8,12,0,0,2,2
2019-01-07 17:27:59.840000,2,1,3,6,2,1,2,5,1,0,3,4
2019-01-07 17:28:04.961000,0,1,2,3,3,1,6,10,0,0,1,1
2019-01-07 17:28:10.303000,2,1,2,5,3,0,2,5,0,0,2,2
2019-01-07 17:28:15.371000,3,0,1,4,2,2,2,6,0,0,2,2
2019-01-07 17:28:20.575000,0,2,3,5,2,2,3,7,0,0,1,1
2019-01-07 17:28:25.594000,2,1,0,3,2,0,1,3,0,0,1,1
2019-01-07 17:28:31.115000,0,0,3,3,3,0,4,7,0,0,2,2
2019-01-07 17:28:36.590000,1,0,1,2,3,2,5,10,0,0,0,0
2019-01-07 17:28:41.991000,2,0,3,5,3,2,1,6,0,0,1,1
2019-01-07 17:28:47.012000,3,0,1,4,2,0,6,8,0,0,1,1
2019-01-07 17:28:52.051000,1,2,4,7,1,3,7,11,0,0,1,1
2019-01-07 17:28:57.379000,2,2,0,4,1,3,5,9,0,0,1,1
2019-01-07 17:29:02.627000,2,2,2,6,0,0,3,3,0,0,2,2
2019-01-07 17:29:07.864000,2,0,2,4,1,1,3,5,0,0,0,0
2019-01-07 17:29:13.532000,2,1,2,5,3,2,4,9,0,0,1,1
2019-01-07 17:29:19.242000,3,1,2,6,0,2,6,8,0,0,1,1
2019-01-07 17:29:24.610000,3,1,1,5,3,2,0,5,0,0,1,1
2019-01-07 17:29:30.974000,1,0,3,4,5,0,7,12,0,0,0,0
2019-01-07 17:29:37.010000,1,1,2,4,1,1,1,3,0,0,0,0
2019-01-07 17:29:42.182000,1,0,3,4,4,3,4,11,0,0,2,2
2019-01-07 17:29:47.488000,2,1,3,6,1,0,5,6,0,0,2,2
2019-01-07 17:29:52.717000,0,0,3,3,1,0,2,3,0,0,2,2
2019-01-07 17:29:58.393000,1,0,0,1,3,0,3,6,0,0,2,2
2019-01-07 17:30:03.750000,4,0,4,8,1,0,5,6,0,0,0,0
2019-01-07 17:30:09.561000,4,1,7,12,3,3,2,8,0,0,2,2
2019-01-07 17:30:14.575000,2,1,2,5,5,0,5,10,0,0,2,2
2019-01-07 17:30:19.613000,1,1,2,4,1,1,3,5,0,0,2,2
2019-01-07 17:30:24.802000,1,0,1,2,5,1,4,10,0,0,1,1
2019-01-07 17:30:29.830000,3,0,1,4,2,0,6,8,0,0,3,3
2019-01-07 17:30:35.965000,1,1,1,3,2,0,0,2,0,0,2,2
2019-01-07 17:30:41.046000,2,0,2,4,2,1,2,5,1,0,2,3
2019-01-07 17:30:46.731000,0,0,0,0,4,0,9,13,0,0,0,0
2019-01-07 17:30:52.784000,2,1,5,8,3,1,3,7,0,0,1,1
2019-01-07 17:30:58.749000,2,0,1,3,6,0,7,13,0,0,2,2
2019-01-07 17:31:04.528000,2,0,3,5,3,0,3,6,0,0,1,1
2019-01-07 17:31:09.871000,2,0,2,4,1,0,4,5,0,0,0,0
2019-01-07 17:31:14.896000,0,0,1,1,3,1,6,10,1,0,2,3
2019-01-07 17:31:20.434000,1,0,1,2,3,1,4,8,0,0,0,0
2019-01-07 17:31:25.738000,0,1,3,4,1,0,4,5,0,0,1,1
2019-01-07 17:31:31.289000,2,0,3,5,3,0,5,8,0,0,1,1
2019-01-07 17:31:36.348000,2,0,5,7,2,0,2,4,0,0,1,1
2019-01-07 17:31:41.462000,2,1,1,4,0,1,4,5,0,0,2,2
2019-01-07 17:31:47.569000,2,0,0,2,0,0,4,4,0,0,0,0
2019-01-07 17:31:52.799000,1,0,1,2,1,1,2,4,0,0,1,1
2019-01-07 17:31:57.996000,0,3,0,3,0,0,4,4,0,0,3,3
2019-01-07 17:32:03.335000,1,0,2,3,4,0,2,6,0,0,1,1
2019-01-07 17:32:08.693000,2,2,1,5,1,1,3,5,0,0,3,3
2019-01-07 17:32:13.927000,0,1,1,2,3,3,4,10,0,0,2,2
2019-01-07 17:32:19.240000,0,1,2,3,1,1,6,8,0,0,0,0
2019-01-07 17:32:24.338000,1,0,3,4,4,1,3,8,1,0,1,2
2019-01-07 17:32:29.471000,2,0,3,5,2,1,4,7,0,0,0,0
2019-01-07 17:32:34.883000,1,0,0,1,1,1,3,5,0,0,1,1
2019-01-07 17:32:40.371000,2,0,4,6,4,0,1,5,0,0,0,0
2019-01-07 17:32:45.872000,6,0,2,8,3,0,8,11,0,0,0,0
2019-01-07 17:32:52.295000,2,0,0,2,3,0,2,5,0,0,0,0
2019-01-07 17:32:57.675000,0,0,1,1,2,0,8,10,0,0,2,2
2019-01-07 17:33:04.893000,2,1,4,7,0,3,3,6,0,1,2,3
2019-01-07 17:33:11.017000,3,0,1,4,5,2,4,11,0,0,1,1
2019-01-07 17:33:16.144000,2,0,3,5,1,0,2,3,0,0,3,3
2019-01-07 17:33:21.640000,2,0,1,3,2,2,3,7,0,0,0,0
2019-01-07 17:33:26.899000,1,0,2,3,2,0,2,4,1,0,5,6
2019-01-07 17:33:32.199000,1,0,6,7,1,2,3,6,0,0,2,2
2019-01-07 17:33:37.352000,0,0,6,6,2,0,4,6,0,0,1,1
2019-01-07 17:33:42.548000,2,0,1,3,3,0,2,5,0,0,1,1
2019-01-07 17:33:47.674000,4,0,0,4,1,0,5,6,0,0,1,1
2019-01-07 17:33:52.911000,2,1,3,6,2,1,5,8,0,0,0,0
2019-01-07 17:33:58.406000,2,1,2,5,3,1,4,8,0,0,2,2
2019-01-07 17:34:05.336000,2,0,2,4,5,0,2,7,0,0,1,1
2019-01-07 17:34:10.660000,2,0,3,5,2,1,3,6,0,0,2,2
2019-01-07 17:34:16.710000,0,0,1,1,4,1,5,10,0,0,0,0
2019-01-07 17:34:21.890000,1,3,3,7,3,1,3,7,0,0,1,1
2019-01-07 17:34:27.330000,1,2,3,6,1,1,2,4,0,0,1,1
2019-01-07 17:34:32.460000,3,0,2,5,2,1,4,7,0,0,1,1
2019-01-07 17:34:37.491000,0,1,3,4,0,0,5,5,0,0,0,0
2019-01-07 17:34:42.971000,0,1,0,1,3,0,4,7,0,0,3,3
2019-01-07 17:34:48.160000,1,0,2,3,5,0,2,7,0,0,1,1
2019-01-07 17:34:53.166000,1,1,3,5,3,0,3,6,1,0,1,2
2019-01-07 17:34:58.489000,2,0,3,5,4,1,2,7,1,0,0,1
2019-01-07 17:35:03.875000,0,0,3,3,2,1,4,7,0,0,2,2
2019-01-07 17:35:09.393000,0,2,1,3,3,3,5,11,0,0,1,1
2019-01-07 17:35:15.834000,0,1,3,4,4,0,2,6,0,0,0,0
2019-01-07 17:35:21.146000,0,0,2,2,3,0,0,3,0,0,1,1
2019-01-07 17:35:27.435000,0,0,2,2,2,0,6,8,0,0,0,0
2019-01-07 17:35:33.296000,1,0,4,5,1,1,3,5,0,0,1,1
2019-01-07 17:35:38.405000,3,0,4,7,1,4,3,8,0,0,0,0
2019-01-07 17:35:44.001000,0,0,1,1,2,0,6,8,0,0,0,0
2019-01-07 17:35:49.105000,0,1,0,1,2,0,5,7,0,0,1,1
2019-01-07 17:35:54.476000,2,1,2,5,2,1,2,5,0,0,0,0
2019-01-07 17:35:59.525000,4,0,1,5,2,4,5,11,1,0,1,2
2019-01-07 17:36:04.803000,4,0,2,6,2,0,3,5,0,0,1,1
2019-01-07 17:36:10.164000,1,1,2,4,2,0,4,6,0,0,0,0
2019-01-07 17:36:15.599000,1,1,1,3,2,2,1,5,0,0,4,4
2019-01-07 17:36:20.700000,1,1,2,4,2,0,4,6,0,0,0,0
2019-01-07 17:36:25.726000,2,0,3,5,1,3,3,7,0,0,1,1
2019-01-07 17:36:31.263000,0,2,2,4,4,0,0,4,0,0,0,0
2019-01-07 17:36:36.640000,1,2,0,3,5,0,4,9,0,0,1,1
2019-01-07 17:36:42.154000,1,0,2,3,2,1,2,5,0,0,1,1
2019-01-07 17:36:49.519000,1,1,1,3,1,2,4,7,0,0,1,1
2019-01-07 17:36:55.244000,0,1,1,2,1,0,5,6,0,0,1,1
2019-01-07 17:37:00.755000,3,0,1,4,2,1,0,3,0,0,2,2
2019-01-07 17:37:05.882000,0,0,4,4,2,1,2,5,0,0,2,2
2019-01-07 17:37:10.948000,0,0,4,4,4,1,4,9,0,0,1,1
2019-01-07 17:37:16.076000,2,1,0,3,4,1,9,14,0,0,1,1
2019-01-07 17:37:21.191000,4,1,3,8,2,3,5,10,0,0,0,0
2019-01-07 17:37:26.452000,0,1,3,4,3,2,6,11,0,0,0,0
2019-01-07 17:37:32.009000,1,0,1,2,0,3,3,6,0,0,0,0
2019-01-07 17:37:37.160000,1,2,3,6,2,0,4,6,0,0,1,1
2019-01-07 17:37:42.551000,1,0,1,2,5,0,2,7,0,0,2,2
2019-01-07 17:37:48.174000,4,2,5,11,1,0,3,4,0,0,0,0
2019-01-07 17:37:53.508000,2,0,1,3,2,0,4,6,0,0,0,0
2019-01-07 17:37:58.542000,1,0,4,5,2,0,5,7,0,0,2,2
2019-01-07 17:38:04.164000,1,2,3,6,5,0,2,7,0,0,0,0
2019-01-07 17:38:09.183000,1,0,3,4,2,0,5,7,0,0,0,0
2019-01-07 17:38:14.562000,1,0,1,2,2,2,3,7,0,0,2,2
2019-01-07 17:38:20.249000,0,1,4,5,1,0,3,4,0,0,1,1
2019-01-07 17:38:26.140000,1,0,3,4,2,0,4,6,0,0,0,0
2019-01-07 17:38:31.212000,3,0,6,9,5,1,2,8,0,0,2,2
2019-01-07 17:38:36.250000,1,0,2,3,5,2,5,12,0,0,1,1
2019-01-07 17:38:41.325000,1,0,1,2,3,0,3,6,1,0,0,1
2019-01-07 17:38:47.091000,1,0,1,2,3,0,5,8,0,0,2,2
2019-01-07 17:38:52.140000,3,0,1,4,4,2,2,8,0,0,0,0
2019-01-07 17:38:58.581000,0,1,0,1,3,0,4,7,0,0,1,1
2019-01-07 17:39:03.814000,1,0,3,4,0,2,5,7,0,0,2,2
2019-01-07 17:39:10.315000,1,1,0,2,6,2,3,11,0,0,0,0
2019-01-07 17:39:15.766000,2,0,1,3,1,1,3,5,0,0,0,0
2019-01-07 17:39:22.513000,2,0,0,2,2,0,5,7,0,0,0,0
2019-01-07 17:39:27.580000,2,0,0,2,1,4,5,10,0,0,0,0
2019-01-07 17:39:33.752000,1,0,4,5,1,1,6,8,0,0,0,0
2019-01-07 17:39:39.229000,1,1,2,4,2,3,1,6,0,0,0,0
2019-01-07 17:39:45.075000,7,1,3,11,3,0,1,4,0,0,1,1
2019-01-07 17:39:50.148000,3,0,2,5,4,1,3,8,0,0,0,0
2019-01-07 17:39:55.555000,0,0,1,1,0,0,3,3,0,0,1,1
2019-01-07 17:40:01.286000,1,2,3,6,1,1,3,5,0,0,2,2
2019-01-07 17:40:06.690000,3,0,2,5,3,2,3,8,0,0,1,1
2019-01-07 17:40:11.881000,0,0,1,1,1,0,6,7,0,0,0,0
2019-01-07 17:40:17.086000,4,0,2,6,1,1,3,5,0,0,2,2
2019-01-07 17:40:22.231000,3,1,3,7,3,0,3,6,0,0,0,0
2019-01-07 17:40:30.223000,1,0,2,3,3,0,1,4,0,0,2,2
2019-01-07 17:40:35.532000,1,2,4,7,1,0,5,6,0,0,1,1
2019-01-07 17:40:40.562000,2,1,2,5,4,0,6,10,0,0,0,0
2019-01-07 17:40:48.584000,0,0,1,1,2,1,1,4,0,0,0,0
2019-01-07 17:40:54.981000,0,0,1,1,1,2,4,7,0,0,3,3
2019-01-07 17:41:00.915000,2,1,1,4,1,0,0,1,0,1,0,1
2019-01-07 17:41:05.980000,2,1,2,5,4,0,3,7,0,0,0,0
2019-01-07 17:41:12.551000,0,0,4,4,2,1,1,4,0,0,1,1
2019-01-07 17:41:17.704000,2,1,1,4,2,1,3,6,0,0,1,1
2019-01-07 17:41:23.080000,4,0,0,4,5,2,5,12,0,0,2,2
2019-01-07 17:41:28.111000,1,0,0,1,5,0,2,7,0,0,0,0
2019-01-07 17:41:33.112000,2,0,1,3,3,1,4,8,0,0,1,1
2019-01-07 17:41:38.512000,1,0,3,4,1,2,2,5,0,0,1,1
2019-01-07 17:41:43.611000,3,0,0,3,1,1,6,8,0,0,4,4
2019-01-07 17:41:48.627000,0,2,1,3,0,0,6,6,0,0,0,0
2019-01-07 17:41:53.695000,2,0,1,3,1,1,4,6,0,0,1,1
2019-01-07 17:41:58.860000,2,1,3,6,0,0,2,2,0,0,0,0
2019-01-07 17:42:04.029000,0,1,0,1,3,3,1,7,0,0,1,1
2019-01-07 17:42:10.006000,2,0,5,7,3,2,4,9,0,0,0,0
2019-01-07 17:42:15.103000,0,1,0,1,2,0,2,4,0,0,0,0
2019-01-07 17:42:20.339000,0,1,1,2,2,0,1,3,1,0,0,1
2019-01-07 17:42:25.493000,2,0,5,7,2,2,1,5,0,0,1,1
2019-01-07 17:42:30.890000,3,0,2,5,4,1,4,9,0,0,1,1
2019-01-07 17:42:35.899000,1,0,0,1,3,2,2,7,0,0,0,0
2019-01-07 17:42:41.862000,2,1,0,3,3,2,3,8,0,0,2,2
2019-01-07 17:42:47.881000,0,3,1,4,2,1,3,6,0,0,1,1
2019-01-07 17:42:54.736000,1,0,3,4,3,0,5,8,0,0,0,0
2019-01-07 17:42:59.941000,0,1,2,3,3,2,2,7,0,0,2,2
2019-01-07 17:43:05.102000,3,0,1,4,0,4,5,9,0,0,1,1
2019-01-07 17:43:10.986000,2,0,1,3,1,2,1,4,0,0,0,0
2019-01-07 17:43:16.084000,2,1,5,8,1,1,3,5,0,0,0,0
2019-01-07 17:43:21.282000,2,0,2,4,2,1,4,7,0,0,0,0
2019-01-07 17:43:28.468000,0,0,2,2,4,0,3,7,0,0,0,0
2019-01-07 17:43:33.605000,2,0,3,5,3,1,4,8,0,0,0,0
2019-01-07 17:43:38.780000,1,0,2,3,1,2,4,7,0,0,0,0
2019-01-07 17:43:44.347000,1,2,4,7,1,3,1,5,0,0,1,1
2019-01-07 17:43:49.661000,3,0,2,5,2,2,2,6,0,0,0,0
2019-01-07 17:43:55.127000,3,0,3,6,0,1,2,3,0,0,2,2
2019-01-07 17:44:00.175000,2,0,4,6,1,0,6,7,0,0,2,2
2019-01-07 17:44:05.176000,3,0,2,5,3,3,2,8,0,0,0,0
2019-01-07 17:44:10.940000,1,0,5,6,5,1,3,9,0,0,0,0
2019-01-07 17:44:16.148000,1,2,2,5,2,1,6,9,0,0,0,0
2019-01-07 17:44:21.661000,1,1,5,7,4,0,3,7,0,0,2,2
2019-01-07 17:44:27.878000,3,1,3,7,4,0,6,10,0,0,2,2
2019-01-07 17:44:32.966000,1,1,3,5,1,0,1,2,0,0,2,2
2019-01-07 17:44:38.559000,2,0,1,3,3,2,3,8,0,0,0,0
2019-01-07 17:44:43.911000,1,2,2,5,1,1,2,4,0,0,2,2
2019-01-07 17:44:49.140000,0,0,3,3,2,2,5,9,0,0,1,1
2019-01-07 17:44:54.710000,1,1,2,4,2,1,4,7,0,0,0,0
2019-01-07 17:44:59.998000,2,0,2,4,2,0,4,6,0,0,1,1
2019-01-07 17:45:05.360000,2,0,1,3,2,4,3,9,0,0,1,1
2019-01-07 17:45:10.373000,0,0,2,2,1,1,5,7,0,0,2,2
2019-01-07 17:45:16.165000,1,0,1,2,1,0,7,8,0,0,0,0
2019-01-07 17:45:21.409000,4,0,2,6,2,2,2,6,0,0,1,1
2019-01-07 17:45:26.552000,2,1,3,6,3,1,5,9,0,0,1,1
2019-01-07 17:45:31.706000,0,1,2,3,4,0,2,6,0,0,0,0
2019-01-07 17:45:37.965000,2,2,1,5,2,1,4,7,0,0,0,0
2019-01-07 17:45:43.365000,6,0,3,9,1,2,4,7,0,0,0,0
2019-01-07 17:45:48.406000,2,0,1,3,3,5,3,11,0,0,0,0
2019-01-07 17:45:53.638000,3,0,1,4,3,2,4,9,0,0,0,0
2019-01-07 17:45:59.105000,1,1,1,3,2,1,1,4,0,0,1,1
2019-01-07 17:46:04.824000,1,0,1,2,1,1,5,7,0,0,0,0
2019-01-07 17:46:10.317000,0,0,4,4,3,1,2,6,0,0,1,1
2019-01-07 17:46:15.362000,4,1,4,9,1,2,2,5,0,0,1,1
2019-01-07 17:46:21.017000,1,1,2,4,2,0,3,5,0,0,0,0
2019-01-07 17:46:26.585000,1,0,5,6,1,1,5,7,0,0,3,3
2019-01-07 17:46:32.806000,3,0,0,3,3,0,3,6,0,0,0,0
2019-01-07 17:46:38.446000,2,0,2,4,3,1,1,5,0,0,1,1
2019-01-07 17:46:43.524000,3,1,2,6,0,2,5,7,1,0,2,3
2019-01-07 17:46:48.548000,1,0,1,2,4,2,2,8,0,0,1,1
2019-01-07 17:46:55.090000,3,0,2,5,2,2,3,7,0,0,0,0
2019-01-07 17:47:00.386000,2,0,2,4,8,0,3,11,0,0,2,2
2019-01-07 17:47:05.697000,4,0,3,7,0,0,1,1,0,0,1,1
2019-01-07 17:47:10.843000,1,0,2,3,3,1,4,8,0,1,0,1
2019-01-07 17:47:16.033000,1,0,3,4,0,0,2,2,0,0,3,3
2019-01-07 17:47:21.322000,3,0,6,9,1,0,6,7,0,0,3,3
2019-01-07 17:47:27.213000,0,0,1,1,1,2,2,5,0,0,2,2
2019-01-07 17:47:32.678000,3,1,2,6,2,2,0,4,0,0,0,0
2019-01-07 17:47:37.858000,0,0,2,2,3,0,2,5,0,0,0,0
2019-01-07 17:47:43.669000,0,0,1,1,4,0,1,5,0,0,0,0
2019-01-07 17:47:49.370000,2,0,1,3,3,1,0,4,0,0,0,0
2019-01-07 17:47:54.578000,2,0,0,2,0,1,2,3,0,0,1,1
2019-01-07 17:48:00.279000,1,0,2,3,4,0,1,5,0,0,0,0
2019-01-07 17:48:05.484000,1,1,1,3,2,0,3,5,0,0,2,2
2019-01-07 17:48:10.802000,1,0,3,4,1,1,4,6,0,0,0,0
2019-01-07 17:48:15.874000,0,1,5,6,1,0,4,5,0,0,3,3
2019-01-07 17:48:21.001000,2,0,2,4,1,1,6,8,0,0,1,1
2019-01-07 17:48:28.925000,2,0,2,4,2,2,3,7,0,0,0,0
2019-01-07 17:48:33.977000,1,0,0,1,1,0,3,4,0,0,1,1
2019-01-07 17:48:39.619000,0,0,3,3,3,2,4,9,0,0,0,0
2019-01-07 17:48:44.843000,1,0,1,2,2,2,4,8,0,0,0,0
2019-01-07 17:48:50.039000,1,0,0,1,4,0,7,11,0,0,1,1
2019-01-07 17:48:55.682000,0,0,3,3,3,1,5,9,0,0,1,1
2019-01-07 17:49:00.807000,0,2,4,6,3,0,5,8,0,0,1,1
2019-01-07 17:49:05.854000,2,0,0,2,4,0,1,5,0,0,0,0
2019-01-07 17:49:11.029000,1,0,3,4,1,1,2,4,0,0,1,1
2019-01-07 17:49:16.128000,2,1,3,6,4,0,3,7,0,0,1,1
2019-01-07 17:49:21.590000,2,0,2,4,3,1,4,8,0,0,0,0
2019-01-07 17:49:27.083000,0,1,1,2,2,2,4,8,0,0,0,0
2019-01-07 17:49:32.509000,2,0,1,3,1,1,1,3,0,0,3,3
2019-01-07 17:49:37.862000,3,0,3,6,3,1,4,8,0,0,1,1
2019-01-07 17:49:42.998000,0,0,2,2,2,0,3,5,0,0,0,0
2019-01-07 17:49:48.642000,2,0,0,2,3,3,3,9,0,0,1,1
2019-01-07 17:49:53.717000,0,1,3,4,1,1,4,6,0,0,0,0
2019-01-07 17:49:59.227000,2,0,5,7,2,1,4,7,0,0,0,0
2019-01-07 17:50:04.568000,1,2,2,5,5,1,5,11,0,0,1,1
2019-01-07 17:50:09.687000,0,0,1,1,2,0,4,6,0,0,1,1
2019-01-07 17:50:15.009000,3,0,2,5,2,0,4,6,1,0,3,4
2019-01-07 17:50:20.030000,0,1,4,5,1,1,3,5,0,0,1,1
2019-01-07 17:50:25.380000,0,0,4,4,2,2,4,8,1,0,1,2
2019-01-07 17:50:30.434000,2,0,0,2,5,2,6,13,0,0,1,1
2019-01-07 17:50:36.818000,1,1,4,6,7,0,5,12,0,0,1,1
2019-01-07 17:50:41.968000,4,1,4,9,2,2,4,8,0,0,0,0
2019-01-07 17:50:47.015000,1,0,3,4,1,3,5,9,0,0,1,1
2019-01-07 17:50:52.076000,2,0,1,3,1,1,4,6,0,0,0,0
2019-01-07 17:50:57.448000,2,0,4,6,0,0,3,3,0,0,0,0
2019-01-07 17:51:02.535000,2,1,1,4,4,1,2,7,0,0,0,0
2019-01-07 17:51:08.292000,2,1,3,6,2,2,3,7,0,0,1,1
2019-01-07 17:51:13.392000,1,1,2,4,0,1,4,5,0,0,1,1
2019-01-07 17:51:18.506000,3,3,1,7,2,0,3,5,0,0,0,0
2019-01-07 17:51:23.917000,1,0,0,1,5,0,2,7,0,0,0,0
2019-01-07 17:51:29.072000,0,4,2,6,2,1,4,7,0,0,1,1
2019-01-07 17:51:34.207000,2,0,2,4,3,2,5,10,0,0,0,0
2019-01-07 17:51:39.245000,2,0,4,6,3,0,4,7,0,0,1,1
2019-01-07 17:51:45.329000,1,1,1,3,5,0,4,9,0,0,0,0
2019-01-07 17:51:51.545000,1,0,1,2,0,2,3,5,0,0,0,0
2019-01-07 17:51:57.506000,2,1,3,6,2,2,6,10,0,0,3,3
2019-01-07 17:52:02.812000,3,1,1,5,4,1,2,7,0,0,1,1
2019-01-07 17:52:07.879000,1,0,3,4,0,1,1,2,0,0,0,0
2019-01-07 17:52:13.353000,2,0,1,3,5,1,2,8,1,0,0,1
2019-01-07 17:52:18.506000,1,0,4,5,3,0,2,5,0,0,3,3
2019-01-07 17:52:23.599000,2,2,3,7,3,4,1,8,0,0,0,0
2019-01-07 17:52:28.924000,1,0,4,5,0,2,7,9,0,0,1,1
2019-01-07 17:52:34.251000,0,2,6,8,2,0,5,7,0,0,1,1
2019-01-07 17:52:40.509000,0,1,1,2,0,2,4,6,0,0,0,0
2019-01-07 17:52:46.618000,0,0,2,2,1,0,5,6,0,0,1,1
2019-01-07 17:52:51.945000,2,3,1,6,4,0,2,6,0,0,0,0
2019-01-07 17:52:59.232000,1,0,3,4,2,0,4,6,0,0,0,0
2019-01-07 17:53:04.948000,4,0,3,7,1,3,1,5,0,0,2,2
2019-01-07 17:53:10.455000,0,0,0,0,4,2,3,9,0,0,1,1
2019-01-07 17:53:16.096000,1,1,2,4,3,0,6,9,0,0,1,1
2019-01-07 17:53:22.636000,0,0,4,4,1,2,5,8,0,0,0,0
2019-01-07 17:53:28.276000,1,1,3,5,3,2,6,11,0,0,2,2
2019-01-07 17:53:33.876000,1,1,2,4,1,0,2,3,0,0,0,0
2019-01-07 17:53:39.094000,1,0,3,4,4,0,6,10,0,0,0,0
2019-01-07 17:53:44.546000,0,0,5,5,8,1,4,13,1,0,0,1
2019-01-07 17:53:49.563000,2,0,4,6,2,1,3,6,1,0,1,2
2019-01-07 17:53:54.737000,3,0,1,4,4,1,2,7,0,0,0,0
2019-01-07 17:54:00.525000,1,1,1,3,4,1,4,9,0,0,2,2
2019-01-07 17:54:05.751000,2,0,2,4,2,0,7,9,0,0,0,0
2019-01-07 17:54:11.247000,3,0,1,4,1,0,3,4,0,0,2,2
2019-01-07 17:54:16.578000,3,0,2,5,3,1,3,7,0,0,1,1
2019-01-07 17:54:21.946000,1,1,1,3,2,1,1,4,0,0,2,2
2019-01-07 17:54:27.403000,1,0,1,2,1,2,5,8,0,0,2,2
2019-01-07 17:55:39.849000,1,0,0,1,0,1,2,3,0,0,0,0
2019-01-07 17:55:45.439000,2,0,1,3,2,0,1,3,0,0,0,0
2019-01-07 17:55:50.721000,2,1,2,5,3,1,1,5,0,0,0,0
2019-01-07 17:55:55.807000,5,0,3,8,5,0,3,8,0,0,0,0
2019-01-07 17:56:02.145000,0,1,4,5,3,2,4,9,0,0,1,1
2019-01-07 17:56:07.430000,2,1,5,8,2,1,5,8,0,0,0,0
2019-01-07 17:56:12.480000,3,1,1,5,2,1,1,4,0,0,1,1
2019-01-07 17:56:18.006000,1,0,1,2,3,1,3,7,1,0,0,1
2019-01-07 17:56:23.672000,3,1,0,4,3,0,9,12,0,1,0,1
2019-01-07 17:56:28.803000,2,0,0,2,0,0,4,4,1,0,0,1
2019-01-07 17:56:34.259000,1,0,1,2,3,2,4,9,0,0,2,2
2019-01-07 17:56:39.775000,4,0,3,7,2,1,4,7,0,0,2,2
2019-01-07 17:56:44.777000,0,1,2,3,4,1,5,10,0,0,1,1
2019-01-07 17:56:50.241000,2,0,0,2,1,0,5,6,0,0,0,0
2019-01-07 17:56:55.586000,1,0,4,5,2,0,4,6,0,0,0,0
2019-01-07 17:57:01.525000,1,0,4,5,2,1,2,5,0,0,2,2
2019-01-07 17:57:06.551000,0,0,3,3,0,0,5,5,0,0,0,0
2019-01-07 17:57:12.265000,0,0,1,1,5,1,2,8,0,1,0,1
2019-01-07 17:57:18.025000,2,1,3,6,1,1,1,3,0,0,2,2
2019-01-07 17:57:23.781000,1,0,1,2,4,2,6,12,0,0,0,0
2019-01-07 17:57:28.809000,2,0,1,3,4,1,6,11,0,0,2,2
2019-01-07 17:57:33.816000,2,1,1,4,4,0,8,12,0,0,1,1
2019-01-07 17:57:39.376000,3,1,0,4,1,2,1,4,0,0,0,0
2019-01-07 17:57:44.627000,2,2,2,6,2,0,3,5,0,0,0,0
2019-01-07 17:57:51.073000,1,0,1,2,2,0,5,7,0,0,0,0
2019-01-07 17:57:56.203000,2,0,1,3,2,1,4,7,0,0,1,1
2019-01-07 17:58:01.707000,3,0,4,7,3,0,2,5,0,0,1,1
2019-01-07 17:58:08.420000,0,1,3,4,1,1,3,5,0,0,1,1
2019-01-07 17:58:14.048000,0,1,5,6,2,1,1,4,0,0,0,0
2019-01-07 17:58:19.248000,0,0,1,1,1,1,9,11,0,0,0,0
2019-01-07 17:58:24.458000,1,1,3,5,1,1,3,5,0,1,1,2
2019-01-07 17:58:29.664000,2,1,2,5,4,0,3,7,0,0,1,1
2019-01-07 17:58:36.210000,2,0,3,5,5,1,1,7,0,0,3,3
2019-01-07 17:58:41.966000,0,1,0,1,2,1,2,5,0,0,0,0
2019-01-07 17:58:47.224000,0,1,2,3,4,0,1,5,0,0,1,1
2019-01-07 17:58:52.320000,2,1,1,4,3,0,8,11,0,0,1,1
2019-01-07 17:58:58.328000,1,1,0,2,4,0,3,7,0,0,1,1
2019-01-07 17:59:03.662000,1,2,1,4,3,0,5,8,0,0,1,1
2019-01-07 17:59:08.679000,3,0,4,7,2,2,0,4,0,0,2,2
2019-01-07 17:59:14.303000,1,2,1,4,1,2,2,5,0,0,1,1
2019-01-07 17:59:19.618000,4,2,3,9,3,1,5,9,0,1,1,2
2019-01-07 17:59:24.956000,1,2,1,4,3,1,6,10,0,0,0,0
2019-01-07 17:59:30.715000,2,1,1,4,2,2,2,6,0,0,0,0
2019-01-07 17:59:35.883000,3,0,2,5,3,0,3,6,0,0,1,1
2019-01-07 17:59:41.254000,1,0,0,1,4,2,4,10,0,0,3,3
2019-01-07 17:59:46.327000,1,0,5,6,5,0,2,7,0,0,1,1
2019-01-07 17:59:51.526000,2,3,0,5,4,2,5,11,0,0,1,1
2019-01-07 17:59:56.787000,0,1,1,2,2,0,3,5,0,0,2,2
2019-01-07 18:00:01.807000,2,0,4,6,3,1,4,8,0,0,1,1
2019-01-07 18:00:07.524000,2,2,2,6,2,0,4,6,0,0,0,0
2019-01-07 18:00:12.591000,4,0,2,6,0,3,7,10,0,0,3,3
2019-01-07 18:00:17.626000,1,1,1,3,3,2,5,10,0,0,0,0
2019-01-07 18:00:22.721000,1,3,2,6,1,2,6,9,0,0,0,0
2019-01-07 18:00:28.678000,2,1,6,9,3,3,5,11,0,0,1,1
2019-01-07 18:00:35.666000,2,1,2,5,2,1,3,6,0,0,0,0
2019-01-07 18:00:41.443000,0,0,3,3,4,0,6,10,0,0,3,3
2019-01-07 18:00:47.299000,2,1,1,4,4,0,3,7,0,0,1,1
2019-01-07 18:00:52.649000,2,1,3,6,4,0,4,8,0,0,1,1
2019-01-07 18:00:58.254000,2,0,2,4,2,1,7,10,0,0,0,0
2019-01-07 18:01:03.983000,2,0,1,3,2,2,1,5,0,0,5,5
2019-01-07 18:01:09.081000,3,2,1,6,2,2,2,6,0,0,2,2
2019-01-07 18:01:14.157000,3,0,1,4,2,3,2,7,0,0,1,1
2019-01-07 18:01:19.325000,1,0,1,2,7,1,4,12,0,0,1,1
2019-01-07 18:01:24.435000,2,2,5,9,3,1,11,15,0,0,0,0
2019-01-07 18:01:29.503000,3,0,2,5,0,2,23,25,0,0,1,1
2019-01-07 18:01:36.119000,1,0,4,5,3,1,3,7,0,0,0,0
2019-01-07 18:01:43.021000,4,0,6,10,3,2,4,9,0,0,2,2
2019-01-07 18:01:48.261000,1,1,2,4,0,1,3,4,0,0,0,0
2019-01-07 18:01:54.830000,2,0,3,5,2,0,5,7,0,0,1,1
2019-01-07 18:02:00.279000,2,0,2,4,4,4,6,14,0,0,3,3
2019-01-07 18:02:05.471000,0,0,5,5,1,3,6,10,0,0,2,2
2019-01-07 18:02:10.651000,2,0,4,6,3,1,1,5,1,0,0,1
2019-01-07 18:02:16.775000,0,1,0,1,6,0,5,11,0,0,1,1
2019-01-07 18:02:21.850000,3,0,4,7,3,1,4,8,0,0,0,0
2019-01-07 18:02:27.504000,1,0,4,5,1,2,4,7,0,0,1,1
2019-01-07 18:02:32.680000,1,0,1,2,1,0,1,2,0,0,0,0
2019-01-07 18:02:38.644000,4,0,1,5,2,0,3,5,0,0,0,0
2019-01-07 18:02:43.801000,5,0,2,7,2,1,4,7,0,0,1,1
2019-01-07 18:02:49.261000,2,0,1,3,1,0,3,4,0,0,1,1
2019-01-07 18:02:54.282000,5,0,2,7,0,1,2,3,0,0,1,1
2019-01-07 18:02:59.621000,2,1,4,7,4,1,4,9,0,0,1,1
2019-01-07 18:03:04.669000,2,1,1,4,1,0,7,8,0,0,3,3
2019-01-07 18:03:09.973000,1,1,3,5,2,1,1,4,0,0,1,1
2019-01-07 18:03:15.037000,1,4,2,7,5,0,5,10,0,0,0,0
2019-01-07 18:03:20.264000,0,0,0,0,3,2,5,10,0,0,1,1
2019-01-07 18:03:25.279000,0,0,3,3,0,2,7,9,0,0,1,1
2019-01-07 18:03:30.713000,0,0,0,0,4,0,1,5,0,0,0,0
2019-01-07 18:03:36.752000,2,0,4,6,2,2,4,8,0,0,1,1
2019-01-07 18:03:41.962000,0,0,4,4,3,0,7,10,0,0,0,0
2019-01-07 18:03:47.162000,1,3,2,6,2,0,6,8,0,0,0,0
2019-01-07 18:03:52.412000,2,0,1,3,3,0,3,6,0,0,0,0
2019-01-07 18:03:57.535000,2,0,0,2,3,0,2,5,0,0,1,1
2019-01-07 18:04:03.323000,1,1,1,3,4,3,3,10,0,0,1,1
2019-01-07 18:04:09.317000,1,2,3,6,1,1,2,4,0,0,0,0
2019-01-07 18:04:14.343000,1,2,4,7,0,0,3,3,0,0,1,1
2019-01-07 18:04:19.561000,2,1,2,5,1,0,7,8,0,0,1,1
2019-01-07 18:04:24.825000,0,0,1,1,1,0,3,4,0,0,0,0
2019-01-07 18:04:30.902000,0,0,5,5,3,0,4,7,0,0,1,1
2019-01-07 18:04:36.268000,3,1,2,6,2,0,2,4,0,0,2,2
2019-01-07 18:04:41.652000,4,1,4,9,2,0,2,4,0,0,0,0
2019-01-07 18:04:47.378000,1,0,2,3,2,2,2,6,0,0,0,0
2019-01-07 18:04:52.431000,0,0,4,4,3,2,4,9,0,0,2,2
2019-01-07 18:04:57.459000,3,0,1,4,1,0,4,5,0,0,1,1
2019-01-07 18:05:02.509000,0,2,5,7,1,1,5,7,0,0,1,1
2019-01-07 18:05:07.717000,0,0,1,1,2,1,6,9,0,0,0,0
2019-01-07 18:05:14.154000,1,0,3,4,6,0,4,10,0,0,1,1
2019-01-07 18:05:19.395000,3,0,3,6,2,0,4,6,0,0,2,2
2019-01-07 18:05:24.874000,1,2,2,5,4,0,1,5,0,0,0,0
2019-01-07 18:05:30.215000,2,1,1,4,1,0,6,7,0,0,0,0
2019-01-07 18:05:35.398000,2,0,4,6,8,1,1,10,0,0,1,1
2019-01-07 18:05:40.525000,1,0,6,7,0,1,3,4,0,0,1,1
2019-01-07 18:05:45.904000,0,1,1,2,4,0,5,9,0,0,1,1
2019-01-07 18:05:51.584000,5,0,6,11,4,1,2,7,0,0,1,1
2019-01-07 18:05:56.921000,0,1,4,5,3,0,4,7,0,0,1,1
2019-01-07 18:06:02.419000,1,2,3,6,1,1,4,6,0,0,0,0
2019-01-07 18:06:07.478000,3,0,1,4,4,0,7,11,0,0,2,2
2019-01-07 18:06:12.828000,4,1,1,6,1,0,2,3,0,0,0,0
2019-01-07 18:06:18.620000,2,0,2,4,6,0,5,11,0,0,0,0
2019-01-07 18:06:23.664000,1,0,1,2,2,0,5,7,0,0,1,1
2019-01-07 18:06:28.690000,2,1,5,8,2,1,4,7,0,0,1,1
2019-01-07 18:06:34.659000,2,2,1,5,3,0,6,9,0,0,2,2
2019-01-07 18:06:40.002000,1,0,2,3,1,0,3,4,0,0,2,2
2019-01-07 18:06:46.141000,1,0,1,2,4,1,3,8,0,0,2,2
2019-01-07 18:06:51.232000,0,0,2,2,2,0,5,7,0,0,2,2
2019-01-07 18:06:56.747000,0,0,1,1,3,0,3,6,0,0,0,0
2019-01-07 18:07:02.400000,3,0,4,7,6,1,4,11,0,0,1,1
2019-01-07 18:07:07.995000,0,2,1,3,0,3,4,7,0,0,1,1
2019-01-07 18:07:12.998000,0,2,2,4,1,0,2,3,0,0,1,1
2019-01-07 18:07:18.496000,2,0,2,4,3,3,5,11,0,0,1,1
2019-01-07 18:07:23.712000,3,0,2,5,3,2,3,8,0,1,1,2
2019-01-07 18:07:28.884000,2,0,0,2,8,4,10,22,0,0,0,0
2019-01-07 18:07:34.015000,0,0,1,1,3,1,1,5,0,0,0,0
2019-01-07 18:07:39.117000,1,1,1,3,2,3,3,8,0,0,1,1
2019-01-07 18:07:44.740000,2,0,2,4,1,0,3,4,0,0,1,1
2019-01-07 18:07:49.764000,2,0,1,3,1,1,4,6,0,0,0,0
2019-01-07 18:07:55.649000,2,1,2,5,2,1,3,6,0,0,0,0
2019-01-07 18:08:00.992000,2,1,0,3,2,0,5,7,0,0,1,1
2019-01-07 18:08:06.133000,1,0,1,2,3,2,4,9,0,0,0,0
2019-01-07 18:08:11.365000,2,3,1,6,7,2,5,14,0,0,0,0
2019-01-07 18:08:16.793000,0,0,1,1,1,0,2,3,0,0,0,0
2019-01-07 18:08:22.913000,1,2,2,5,3,2,2,7,0,0,2,2
2019-01-07 18:08:28.905000,0,0,4,4,3,0,2,5,0,0,4,4
2019-01-07 18:08:34.127000,4,0,4,8,4,1,1,6,0,0,0,0
2019-01-07 18:08:40.620000,2,2,0,4,0,0,5,5,0,0,0,0
2019-01-07 18:08:46.378000,1,1,1,3,1,0,3,4,0,0,1,1
2019-01-07 18:08:52.611000,2,0,2,4,3,0,4,7,0,0,0,0
2019-01-07 18:08:57.757000,3,0,3,6,2,2,2,6,0,0,4,4
2019-01-07 18:09:02.970000,0,0,3,3,8,1,4,13,0,0,1,1
2019-01-07 18:09:08.357000,0,1,2,3,3,0,1,4,0,0,1,1
2019-01-07 18:09:13.988000,1,0,3,4,0,0,2,2,0,0,1,1
2019-01-07 18:09:19.628000,2,0,4,6,1,1,6,8,0,0,0,0
2019-01-07 18:09:24.792000,3,0,3,6,3,1,3,7,0,0,2,2
2019-01-07 18:09:30.080000,1,0,1,2,0,2,3,5,1,0,0,1
2019-01-07 18:09:35.453000,1,1,4,6,1,2,0,3,0,0,2,2
2019-01-07 18:09:40.650000,3,2,4,9,3,2,4,9,0,1,2,3
2019-01-07 18:09:45.867000,1,0,4,5,2,0,4,6,0,0,4,4
2019-01-07 18:09:50.893000,2,1,3,6,3,0,3,6,0,0,1,1
2019-01-07 18:09:55.997000,1,0,3,4,2,0,3,5,0,0,3,3
2019-01-07 18:10:01.050000,4,0,1,5,1,0,2,3,0,0,1,1
2019-01-07 18:10:06.366000,0,2,5,7,2,2,2,6,0,0,3,3
2019-01-07 18:10:11.703000,1,0,0,1,4,1,3,8,0,0,2,2
2019-01-07 18:10:16.801000,3,1,1,5,3,0,4,7,0,0,1,1
2019-01-07 18:10:23.259000,0,0,3,3,2,1,4,7,0,0,0,0
2019-01-07 18:10:28.727000,3,0,3,6,3,2,4,9,0,0,1,1
2019-01-07 18:10:34.096000,0,0,2,2,2,1,4,7,0,1,0,1
2019-01-07 18:10:39.244000,3,0,3,6,2,1,3,6,0,0,1,1
2019-01-07 18:10:44.547000,0,2,2,4,1,0,2,3,0,0,0,0
2019-01-07 18:10:49.752000,2,0,0,2,1,2,3,6,0,0,3,3
2019-01-07 18:10:55.399000,3,0,1,4,3,0,3,6,0,0,1,1
2019-01-07 18:11:00.516000,1,1,2,4,2,1,3,6,0,0,0,0
2019-01-07 18:11:05.962000,1,1,5,7,2,1,4,7,0,0,0,0
2019-01-07 18:11:11.210000,1,0,0,1,0,2,2,4,0,0,0,0
2019-01-07 18:11:16.671000,1,3,5,9,8,0,4,12,0,0,2,2
2019-01-07 18:11:21.753000,1,1,4,6,2,1,6,9,0,0,1,1
2019-01-07 18:11:27.287000,0,0,1,1,2,1,1,4,0,0,0,0
2019-01-07 18:11:32.402000,8,0,2,10,2,2,4,8,0,1,0,1
2019-01-07 18:11:37.995000,0,0,2,2,3,1,4,8,0,0,1,1
2019-01-07 18:11:43.569000,1,2,0,3,2,1,4,7,0,0,2,2
2019-01-07 18:11:49.694000,1,1,3,5,1,1,2,4,0,0,1,1
2019-01-07 18:11:55.745000,0,0,2,2,1,0,4,5,0,0,2,2
2019-01-07 18:12:00.792000,3,0,1,4,3,0,1,4,0,0,0,0
2019-01-07 18:12:06.364000,2,0,3,5,3,2,2,7,0,0,0,0
2019-01-07 18:12:11.934000,2,0,1,3,3,2,1,6,0,0,0,0
2019-01-07 18:12:17.067000,2,0,3,5,1,0,7,8,1,0,1,2
2019-01-07 18:12:22.161000,0,0,1,1,4,0,3,7,0,0,0,0
2019-01-07 18:12:27.250000,0,0,5,5,2,2,12,16,0,0,2,2
2019-01-07 18:12:32.722000,1,1,1,3,1,3,6,10,1,0,0,1
2019-01-07 18:12:38.105000,0,0,4,4,1,2,3,6,0,0,1,1
2019-01-07 18:12:43.320000,1,0,3,4,4,2,2,8,0,0,2,2
2019-01-07 18:12:48.399000,1,1,4,6,0,0,4,4,0,0,0,0
2019-01-07 18:12:55.100000,3,2,4,9,0,1,4,5,0,1,2,3
2019-01-07 18:13:00.836000,0,1,1,2,4,1,4,9,0,0,0,0
2019-01-07 18:13:05.918000,3,0,3,6,1,0,3,4,0,0,1,1
2019-01-07 18:13:12.149000,2,0,0,2,1,0,3,4,0,0,1,1
2019-01-07 18:13:17.183000,1,2,1,4,2,1,5,8,0,0,0,0
2019-01-07 18:13:22.198000,0,0,2,2,5,0,3,8,0,0,3,3
2019-01-07 18:13:28.598000,1,1,1,3,2,0,4,6,0,0,0,0
2019-01-07 18:13:33.790000,2,0,0,2,1,0,0,1,0,0,1,1
2019-01-07 18:13:39.159000,0,0,1,1,1,1,5,7,0,0,1,1
2019-01-07 18:13:45.284000,4,0,3,7,0,0,0,0,0,0,1,1
2019-01-07 18:13:50.519000,0,0,0,0,1,0,0,1,0,0,2,2
2019-01-07 18:13:55.938000,2,1,2,5,3,1,3,7,0,0,0,0
2019-01-07 18:14:02.306000,1,1,3,5,2,3,4,9,0,0,0,0
2019-01-07 18:14:08.051000,1,0,4,5,3,0,2,5,0,0,2,2
2019-01-07 18:14:13.056000,0,0,2,2,1,2,4,7,0,0,1,1
2019-01-07 18:14:18.630000,1,1,4,6,3,1,3,7,0,0,2,2
2019-01-07 18:14:24.033000,1,1,1,3,3,2,3,8,0,0,0,0
2019-01-07 18:14:29.059000,2,1,4,7,3,1,4,8,0,0,0,0
2019-01-07 18:14:34.137000,2,0,0,2,0,3,2,5,0,0,2,2
2019-01-07 18:14:39.459000,2,0,1,3,3,0,6,9,0,0,1,1
2019-01-07 18:14:44.758000,1,1,5,7,0,0,0,0,0,0,0,0
2019-01-07 18:14:50.195000,3,0,1,4,2,1,1,4,0,0,1,1
2019-01-07 18:14:55.350000,2,0,2,4,0,2,3,5,0,0,1,1
2019-01-07 18:15:00.642000,0,0,1,1,1,1,4,6,0,0,1,1
2019-01-07 18:15:05.799000,1,0,1,2,2,1,3,6,0,0,1,1
2019-01-07 18:15:11.843000,2,2,5,9,1,1,2,4,0,0,2,2
2019-01-07 18:15:17.822000,3,0,1,4,5,0,5,10,0,0,1,1
2019-01-07 18:15:24.047000,3,1,2,6,6,0,5,11,0,0,1,1
2019-01-07 18:15:29.167000,0,1,1,2,0,1,6,7,0,0,0,0
2019-01-07 18:15:35.006000,2,0,2,4,0,1,4,5,0,0,1,1
2019-01-07 18:15:40.476000,0,0,2,2,5,0,1,6,0,0,0,0
2019-01-07 18:15:45.570000,2,1,2,5,1,3,3,7,0,0,3,3
2019-01-07 18:15:50.777000,0,0,2,2,3,2,1,6,0,0,0,0
2019-01-07 18:15:56.459000,0,0,1,1,3,0,2,5,0,0,0,0
2019-01-07 18:16:02.266000,2,1,3,6,0,1,3,4,0,0,0,0
2019-01-07 18:16:07.336000,2,2,3,7,2,1,2,5,0,0,1,1
2019-01-07 18:16:13.740000,1,2,1,4,0,1,2,3,0,0,1,1
2019-01-07 18:16:18.987000,1,0,0,1,2,0,3,5,0,0,0,0
2019-01-07 18:16:24.515000,0,0,2,2,0,6,0,6,0,0,1,1
2019-01-07 18:16:29.771000,0,1,2,3,3,1,3,7,0,0,0,0
2019-01-07 18:16:35.437000,3,1,1,5,4,1,1,6,0,0,0,0
2019-01-07 18:16:40.817000,0,0,3,3,3,3,1,7,0,0,0,0
2019-01-07 18:16:46.240000,2,0,0,2,3,2,4,9,0,0,0,0
2019-01-07 18:16:52.082000,2,1,1,4,3,0,6,9,0,0,0,0
2019-01-07 18:16:57.513000,0,0,3,3,2,1,2,5,0,0,1,1
2019-01-07 18:17:02.552000,2,1,2,5,3,1,3,7,0,0,1,1
2019-01-07 18:17:09.662000,3,1,4,8,4,0,3,7,0,0,1,1
2019-01-07 18:17:15.057000,0,2,0,2,4,0,3,7,0,0,1,1
2019-01-07 18:17:20.456000,1,0,1,2,0,0,5,5,0,0,2,2
2019-01-07 18:17:25.523000,3,0,1,4,1,2,5,8,0,0,0,0
2019-01-07 18:17:30.976000,1,0,2,3,5,0,7,12,0,1,1,2
2019-01-07 18:17:36.082000,2,1,0,3,2,1,5,8,0,0,1,1
2019-01-07 18:17:41.273000,1,1,4,6,2,0,2,4,0,0,0,0
2019-01-07 18:17:46.555000,0,2,3,5,5,0,3,8,0,0,0,0
2019-01-07 18:17:52.660000,3,2,2,7,3,1,5,9,0,0,1,1
2019-01-07 18:17:58.279000,2,0,2,4,0,0,4,4,0,0,0,0
2019-01-07 18:18:03.597000,5,2,3,10,4,3,3,10,0,0,1,1
2019-01-07 18:18:09.017000,1,1,3,5,1,0,4,5,0,0,1,1
2019-01-07 18:18:15.054000,0,0,5,5,3,2,3,8,0,0,1,1
2019-01-07 18:18:20.058000,1,0,5,6,2,0,5,7,0,0,0,0
2019-01-07 18:18:25.177000,1,1,3,5,2,0,4,6,0,0,2,2
2019-01-07 18:18:30.439000,0,0,1,1,4,0,4,8,0,0,2,2
2019-01-07 18:18:35.495000,1,1,2,4,2,1,4,7,0,0,0,0
2019-01-07 18:18:40.836000,3,2,0,5,0,1,5,6,0,0,0,0
2019-01-07 18:18:45.863000,2,1,1,4,2,2,5,9,0,0,0,0
2019-01-07 18:18:50.910000,1,1,4,6,2,0,3,5,0,0,0,0
2019-01-07 18:18:55.982000,3,1,0,4,2,0,1,3,0,0,0,0
2019-01-07 18:19:01.971000,3,0,4,7,2,1,5,8,0,0,0,0
2019-01-07 18:19:07.246000,1,1,3,5,4,1,4,9,0,0,2,2
2019-01-07 18:19:12.281000,1,0,2,3,0,0,3,3,0,0,1,1
2019-01-07 18:19:17.910000,2,0,2,4,5,0,3,8,0,0,0,0
2019-01-07 18:19:23.410000,2,0,0,2,4,0,6,10,0,0,1,1
2019-01-07 18:19:29.638000,1,2,1,4,1,1,2,4,0,0,1,1
2019-01-07 18:19:35.190000,2,0,3,5,0,1,3,4,0,0,0,0
2019-01-07 18:19:40.250000,2,0,6,8,2,2,3,7,0,0,3,3
2019-01-07 18:19:45.298000,3,1,2,6,2,0,1,3,0,0,0,0
2019-01-07 18:19:50.535000,1,0,3,4,0,0,3,3,0,0,0,0
2019-01-07 18:19:55.726000,3,0,4,7,2,1,2,5,0,0,0,0
2019-01-07 18:20:01.201000,1,0,1,2,4,1,4,9,0,0,2,2
2019-01-07 18:20:06.283000,2,0,0,2,1,0,3,4,0,0,0,0
2019-01-07 18:20:11.375000,3,1,4,8,2,1,5,8,0,0,2,2
2019-01-07 18:20:17.127000,4,1,2,7,2,1,1,4,0,0,0,0
2019-01-07 18:20:23.810000,2,0,1,3,5,1,3,9,0,0,4,4
2019-01-07 18:20:28.947000,5,0,1,6,3,0,6,9,0,0,2,2
2019-01-07 18:20:34.516000,1,0,2,3,2,0,2,4,0,0,1,1
2019-01-07 18:20:39.705000,2,1,1,4,4,0,3,7,1,0,1,2
2019-01-07 18:20:45.126000,1,1,3,5,3,1,0,4,0,0,1,1
2019-01-07 18:20:50.164000,1,0,2,3,1,0,5,6,0,1,0,1
2019-01-07 18:20:55.258000,1,0,3,4,1,1,4,6,0,0,0,0
2019-01-07 18:21:00.372000,0,2,0,2,1,2,2,5,0,0,0,0
2019-01-07 18:21:05.814000,2,0,0,2,0,2,2,4,0,0,1,1
2019-01-07 18:21:12.214000,2,0,3,5,2,0,5,7,0,0,0,0
2019-01-07 18:21:18.062000,1,1,1,3,1,1,5,7,0,0,0,0
2019-01-07 18:21:24.428000,0,0,4,4,0,1,10,11,0,0,0,0
2019-01-07 18:21:29.538000,2,1,3,6,2,2,2,6,0,0,1,1
2019-01-07 18:21:34.812000,2,0,2,4,2,0,4,6,0,0,3,3
2019-01-07 18:21:40.088000,0,0,3,3,0,2,3,5,0,0,1,1
2019-01-07 18:21:45.271000,0,0,3,3,3,0,3,6,0,1,1,2
2019-01-07 18:21:50.579000,2,0,4,6,2,1,4,7,0,0,1,1
2019-01-07 18:21:57.464000,0,1,1,2,2,1,4,7,0,0,1,1
2019-01-07 18:22:02.778000,0,0,1,1,3,0,1,4,0,0,2,2
2019-01-07 18:22:08.577000,5,1,2,8,3,1,2,6,0,0,0,0
2019-01-07 18:22:13.824000,1,0,1,2,3,2,5,10,0,0,1,1
2019-01-07 18:22:18.968000,2,1,1,4,2,1,3,6,0,0,3,3
2019-01-07 18:22:24.008000,2,0,1,3,3,0,4,7,0,0,3,3
2019-01-07 18:22:29.178000,2,0,2,4,1,1,0,2,0,0,1,1
2019-01-07 18:22:34.515000,5,1,1,7,3,0,2,5,0,0,0,0
2019-01-07 18:22:40.482000,2,0,3,5,3,3,6,12,0,0,2,2
2019-01-07 18:22:46.569000,0,0,2,2,3,1,1,5,0,0,1,1
2019-01-07 18:22:52.465000,0,1,0,1,2,0,3,5,0,0,1,1
2019-01-07 18:22:58.487000,0,3,1,4,4,0,0,4,0,0,1,1
2019-01-07 18:23:04.598000,1,0,1,2,2,3,3,8,0,0,0,0
2019-01-07 18:23:09.969000,0,1,1,2,1,0,5,6,0,0,2,2
2019-01-07 18:23:15.033000,3,0,1,4,2,1,7,10,0,0,2,2
2019-01-07 18:23:20.317000,2,3,2,7,3,0,1,4,0,0,1,1
2019-01-07 18:23:25.606000,2,0,2,4,1,0,1,2,0,0,2,2
2019-01-07 18:23:30.755000,2,0,3,5,2,2,1,5,0,0,1,1
2019-01-07 18:23:36.482000,2,2,2,6,2,0,3,5,0,0,2,2
2019-01-07 18:23:41.591000,2,0,0,2,2,0,2,4,0,0,2,2
2019-01-07 18:23:46.613000,4,1,2,7,3,3,8,14,0,0,1,1
2019-01-07 18:23:51.920000,2,2,4,8,2,0,2,4,0,0,2,2
2019-01-07 18:23:58.897000,1,0,1,2,0,0,1,1,0,0,2,2
2019-01-07 18:24:04.638000,2,1,3,6,2,1,4,7,0,0,2,2
2019-01-07 18:24:10.758000,2,2,3,7,1,2,4,7,0,0,0,0
2019-01-07 18:24:16.135000,1,1,3,5,2,0,4,6,0,0,1,1
2019-01-07 18:24:21.828000,1,2,3,6,1,1,2,4,0,0,0,0
2019-01-07 18:24:27.229000,3,0,1,4,1,2,2,5,0,0,0,0
2019-01-07 18:24:32.353000,1,0,3,4,3,1,5,9,0,0,2,2
2019-01-07 18:24:37.661000,2,0,2,4,0,1,4,5,0,0,0,0
2019-01-07 18:24:43.003000,2,1,1,4,1,4,4,9,0,0,0,0
2019-01-07 18:24:48.202000,2,0,1,3,3,0,3,6,0,0,2,2
2019-01-07 18:24:53.597000,1,1,4,6,3,0,4,7,0,0,0,0
2019-01-07 18:24:59.146000,2,0,4,6,5,1,4,10,0,0,0,0
2019-01-07 18:25:04.690000,1,0,2,3,2,0,3,5,0,0,2,2
2019-01-07 18:25:10.418000,3,0,2,5,2,1,5,8,1,0,0,1
2019-01-07 18:25:15.747000,3,0,1,4,1,0,5,6,0,0,0,0
2019-01-07 18:25:20.780000,1,1,2,4,1,0,5,6,0,0,0,0
2019-01-07 18:25:26.268000,0,0,2,2,3,2,2,7,0,0,0,0
2019-01-07 18:25:31.589000,1,0,3,4,0,1,5,6,0,0,2,2
2019-01-07 18:25:37.223000,2,0,2,4,3,2,2,7,0,0,0,0
2019-01-07 18:25:43.096000,1,0,2,3,3,1,1,5,0,0,1,1
2019-01-07 18:25:48.457000,2,0,4,6,4,0,5,9,0,0,2,2
2019-01-07 18:25:53.977000,1,0,1,2,2,2,11,15,0,0,0,0
2019-01-07 18:25:59.651000,1,0,3,4,3,0,4,7,0,0,0,0
2019-01-07 18:26:05.274000,3,0,3,6,2,0,4,6,0,1,1,2
2019-01-07 18:26:10.745000,0,1,0,1,1,0,2,3,0,0,1,1
2019-01-07 18:26:15.880000,2,2,1,5,2,0,1,3,0,0,0,0
2019-01-07 18:26:21.627000,1,1,1,3,1,0,2,3,0,0,0,0
2019-01-07 18:26:27.089000,3,1,2,6,2,1,1,4,0,0,2,2
2019-01-07 18:26:32.402000,4,0,3,7,3,3,5,11,0,0,1,1
2019-01-07 18:26:38.208000,1,1,2,4,1,0,2,3,1,0,0,1
2019-01-07 18:26:43.768000,2,0,2,4,2,1,3,6,0,0,0,0
2019-01-07 18:26:48.807000,3,0,1,4,4,3,9,16,0,0,0,0
2019-01-07 18:26:53.848000,1,0,0,1,3,1,4,8,0,0,2,2
2019-01-07 18:26:59.234000,1,1,3,5,3,0,2,5,0,0,0,0
2019-01-07 18:27:04.798000,0,0,3,3,4,1,4,9,0,0,0,0
2019-01-07 18:27:10.022000,2,0,1,3,1,1,5,7,0,0,0,0
2019-01-07 18:27:15.729000,2,0,3,5,2,0,1,3,0,0,0,0
2019-01-07 18:27:21.175000,5,0,4,9,0,2,5,7,0,0,1,1
2019-01-07 18:27:26.585000,2,0,1,3,4,3,4,11,0,0,0,0
2019-01-07 18:27:31.751000,3,0,2,5,2,1,8,11,0,0,1,1
2019-01-07 18:27:37.421000,2,1,1,4,1,0,3,4,0,0,0,0
2019-01-07 18:27:42.794000,2,1,2,5,3,1,5,9,0,0,1,1
2019-01-07 18:27:47.863000,1,2,3,6,2,0,7,9,1,0,1,2
2019-01-07 18:27:53.367000,1,1,2,4,0,2,3,5,0,0,0,0
2019-01-07 18:27:58.602000,3,1,4,8,2,1,2,5,0,1,0,1
2019-01-07 18:28:04.045000,1,0,1,2,0,0,3,3,0,0,0,0
2019-01-07 18:28:09.259000,2,0,1,3,3,1,2,6,0,0,1,1
2019-01-07 18:28:14.533000,0,2,2,4,3,7,6,16,0,0,1,1
2019-01-07 18:28:19.871000,0,0,1,1,6,0,4,10,0,0,0,0
2019-01-07 18:28:25.031000,2,1,0,3,2,1,7,10,0,0,1,1
2019-01-07 18:28:30.296000,1,0,3,4,1,2,5,8,0,0,1,1
2019-01-07 18:28:35.560000,1,1,4,6,0,2,1,3,0,0,0,0
2019-01-07 18:28:40.785000,3,1,0,4,3,1,2,6,0,0,1,1
2019-01-07 18:28:46.817000,4,0,1,5,0,1,3,4,0,0,2,2
2019-01-07 18:28:52.468000,1,0,1,2,0,0,4,4,0,0,0,0
2019-01-07 18:28:57.594000,1,2,4,7,0,1,4,5,0,0,0,0
2019-01-07 18:29:04.236000,1,0,1,2,4,2,2,8,0,0,1,1
2019-01-07 18:29:10.574000,4,1,3,8,1,0,1,2,0,0,0,0
2019-01-07 18:29:17.218000,2,0,2,4,2,1,3,6,0,0,2,2
2019-01-07 18:29:22.805000,4,2,2,8,2,1,2,5,0,0,0,0
2019-01-07 18:29:28.180000,1,2,3,6,2,1,1,4,0,0,0,0
2019-01-07 18:29:34.170000,0,1,2,3,3,1,4,8,0,0,1,1
2019-01-07 18:29:39.420000,2,0,3,5,1,1,4,6,0,0,0,0
2019-01-07 18:29:44.841000,2,1,4,7,4,1,5,10,0,1,1,2
2019-01-07 18:29:49.873000,1,1,1,3,3,0,2,5,0,0,0,0
2019-01-07 18:29:55.095000,2,0,2,4,0,2,3,5,0,0,0,0
2019-01-07 18:30:00.427000,1,0,1,2,1,1,4,6,0,0,0,0
2019-01-07 18:30:05.949000,2,0,1,3,2,1,4,7,0,0,1,1
2019-01-07 18:30:11.213000,2,0,1,3,5,0,2,7,0,0,0,0
2019-01-07 18:30:16.561000,0,1,3,4,3,0,3,6,0,0,1,1
2019-01-07 18:30:21.805000,1,3,1,5,3,3,9,15,0,0,1,1
2019-01-07 18:30:27.847000,2,0,2,4,0,0,1,1,0,0,0,0
2019-01-07 18:30:34.526000,2,1,0,3,1,1,5,7,0,0,0,0
2019-01-07 18:30:39.835000,2,0,6,8,1,0,4,5,0,0,1,1
2019-01-07 18:30:45.788000,2,0,2,4,0,0,3,3,0,0,0,0
2019-01-07 18:30:51.741000,3,0,2,5,2,0,7,9,0,0,0,0
2019-01-07 18:30:57.399000,1,0,5,6,2,0,4,6,0,0,1,1
2019-01-07 18:31:02.618000,0,0,4,4,3,0,7,10,0,0,1,1
2019-01-07 18:31:07.920000,0,2,5,7,0,1,2,3,0,0,0,0
2019-01-07 18:31:13.312000,1,0,2,3,5,1,2,8,0,0,2,2
2019-01-07 18:31:19.025000,3,0,0,3,2,0,1,3,1,0,1,2
2019-01-07 18:31:24.115000,3,2,0,5,2,1,2,5,0,0,0,0
2019-01-07 18:31:29.710000,1,0,0,1,1,2,5,8,0,0,0,0
2019-01-07 18:31:34.733000,2,1,3,6,5,4,2,11,0,0,1,1
2019-01-07 18:31:39.972000,2,1,3,6,1,0,4,5,0,0,0,0
2019-01-07 18:31:45.042000,1,0,1,2,2,0,4,6,0,0,0,0
2019-01-07 18:31:50.106000,5,1,3,9,2,1,0,3,0,0,0,0
2019-01-07 18:31:55.339000,1,0,7,8,3,0,5,8,0,0,0,0
2019-01-07 18:32:00.609000,6,0,5,11,6,1,3,10,0,0,1,1
2019-01-07 18:32:06.098000,0,0,2,2,1,2,5,8,0,0,0,0
2019-01-07 18:32:11.352000,2,0,6,8,4,0,3,7,0,0,0,0
2019-01-07 18:32:16.508000,4,1,2,7,3,1,4,8,0,0,2,2
2019-01-07 18:32:21.974000,1,0,2,3,3,0,3,6,0,0,1,1
2019-01-07 18:32:26.981000,2,0,1,3,1,1,4,6,0,0,0,0
2019-01-07 18:32:32.077000,2,1,0,3,0,0,4,4,0,0,2,2
2019-01-07 18:32:37.140000,2,0,1,3,1,1,3,5,0,0,0,0
2019-01-07 18:32:42.426000,1,0,2,3,4,1,1,6,0,0,0,0
2019-01-07 18:32:48.075000,2,0,1,3,1,0,1,2,0,0,1,1
2019-01-07 18:32:53.545000,1,0,1,2,2,2,7,11,0,0,1,1
2019-01-07 18:32:58.943000,1,0,2,3,5,1,1,7,0,0,1,1
2019-01-07 18:33:03.995000,2,0,1,3,1,1,2,4,0,0,2,2
2019-01-07 18:33:09.134000,1,0,1,2,3,0,5,8,0,0,0,0
2019-01-07 18:33:14.403000,2,0,3,5,5,0,3,8,0,0,1,1
2019-01-07 18:33:20.314000,3,0,2,5,2,0,1,3,0,0,1,1
2019-01-07 18:33:25.738000,0,1,1,2,4,0,1,5,0,0,3,3
2019-01-07 18:33:32.921000,3,0,1,4,2,2,4,8,0,0,1,1
2019-01-07 18:33:38.415000,3,3,0,6,0,0,4,4,0,0,2,2
2019-01-07 18:33:43.742000,1,1,1,3,2,1,7,10,0,0,0,0
2019-01-07 18:33:49.144000,2,0,2,4,7,0,4,11,1,0,3,4
2019-01-07 18:33:54.568000,2,1,0,3,0,1,3,4,0,0,3,3
2019-01-07 18:33:59.775000,0,0,1,1,2,0,3,5,0,0,0,0
2019-01-07 18:34:04.974000,3,0,2,5,3,2,4,9,0,0,0,0
2019-01-07 18:34:10.639000,4,0,4,8,3,1,4,8,0,0,2,2
2019-01-07 18:34:15.676000,4,2,5,11,1,1,4,6,0,0,0,0
2019-01-07 18:34:20.789000,0,0,2,2,4,0,3,7,0,0,0,0
2019-01-07 18:34:25.809000,1,0,1,2,5,0,4,9,0,0,1,1
2019-01-07 18:34:31.011000,0,0,5,5,2,0,3,5,0,0,0,0
2019-01-07 18:34:36.655000,1,0,3,4,4,1,4,9,0,0,1,1
2019-01-07 18:34:42.226000,0,1,4,5,2,1,3,6,0,1,0,1
2019-01-07 18:34:47.425000,2,0,3,5,2,1,4,7,0,0,1,1
2019-01-07 18:34:52.568000,1,1,3,5,1,1,5,7,0,0,0,0
2019-01-07 18:34:57.730000,2,2,4,8,4,0,3,7,0,0,0,0
2019-01-07 18:35:02.769000,3,0,1,4,1,1,3,5,0,0,0,0
2019-01-07 18:35:07.800000,3,1,3,7,1,1,5,7,0,0,0,0
2019-01-07 18:35:12.912000,2,1,4,7,3,1,6,10,0,0,0,0
2019-01-07 18:35:18.707000,1,0,2,3,2,1,7,10,0,0,2,2
2019-01-07 18:35:23.798000,1,0,1,2,1,0,1,2,0,0,1,1
2019-01-07 18:35:29.222000,1,0,3,4,0,0,2,2,0,0,2,2
2019-01-07 18:35:34.372000,3,0,5,8,2,0,3,5,0,0,1,1
2019-01-07 18:35:40.434000,4,0,2,6,1,2,3,6,0,0,2,2
2019-01-07 18:35:45.792000,0,1,3,4,1,1,3,5,0,0,1,1
2019-01-07 18:35:51.012000,0,2,1,3,3,0,2,5,0,0,0,0
2019-01-07 18:35:56.427000,2,1,2,5,2,1,5,8,0,0,0,0
2019-01-07 18:36:01.454000,1,1,3,5,4,1,1,6,0,0,2,2
2019-01-07 18:36:06.835000,2,1,5,8,3,0,0,3,0,0,1,1
2019-01-07 18:36:11.978000,2,2,2,6,5,2,2,9,0,0,0,0
2019-01-07 18:36:17.236000,0,1,2,3,2,1,4,7,0,0,0,0
2019-01-07 18:36:22.392000,0,2,3,5,1,0,6,7,0,0,1,1
2019-01-07 18:36:27.437000,2,1,2,5,3,0,2,5,0,0,1,1
2019-01-07 18:36:32.482000,2,2,1,5,2,1,2,5,0,0,1,1
2019-01-07 18:36:38.122000,1,1,1,3,0,1,6,7,0,0,0,0
2019-01-07 18:36:43.327000,1,0,4,5,3,1,3,7,0,0,0,0
2019-01-07 18:36:49.109000,1,0,3,4,2,1,2,5,0,0,1,1
2019-01-07 18:36:54.539000,1,1,2,4,1,1,2,4,0,0,1,1
2019-01-07 18:37:00.041000,0,1,4,5,4,1,7,12,0,0,1,1
2019-01-07 18:37:05.413000,3,0,1,4,1,0,5,6,0,0,2,2
2019-01-07 18:37:10.520000,1,0,4,5,4,0,1,5,0,0,1,1
2019-01-07 18:37:16.655000,2,1,3,6,2,1,5,8,0,0,1,1
2019-01-07 18:37:22.638000,0,0,4,4,3,1,2,6,0,0,0,0
2019-01-07 18:37:28.194000,2,0,4,6,1,0,2,3,0,0,1,1
2019-01-07 18:37:34.332000,2,0,3,5,1,3,6,10,0,0,0,0
2019-01-07 18:37:39.397000,2,0,1,3,1,1,1,3,0,0,0,0
2019-01-07 18:37:44.433000,2,0,2,4,3,0,4,7,0,0,0,0
2019-01-07 18:37:49.455000,2,1,2,5,1,2,4,7,0,0,0,0
2019-01-07 18:37:54.852000,2,1,3,6,3,1,2,6,0,0,0,0
2019-01-07 18:38:00.109000,2,0,3,5,0,0,4,4,0,0,0,0
2019-01-07 18:38:05.635000,3,0,3,6,1,0,5,6,0,0,0,0
2019-01-07 18:38:10.786000,1,0,2,3,2,0,5,7,0,0,1,1
2019-01-07 18:38:15.835000,0,0,2,2,2,2,3,7,0,0,2,2
2019-01-07 18:38:21.313000,1,0,3,4,2,1,6,9,0,0,0,0
2019-01-07 18:38:26.360000,3,1,1,5,3,1,3,7,0,0,0,0
2019-01-07 18:38:31.460000,1,0,1,2,0,2,2,4,0,0,0,0
2019-01-07 18:38:36.601000,2,1,1,4,1,2,4,7,0,0,1,1
2019-01-07 18:38:41.608000,2,1,1,4,3,2,3,8,0,0,1,1
2019-01-07 18:38:46.612000,1,0,1,2,3,0,6,9,0,0,0,0
2019-01-07 18:38:52.259000,1,0,4,5,3,0,3,6,0,0,0,0
2019-01-07 18:38:57.363000,1,0,3,4,3,0,2,5,0,0,0,0
2019-01-07 18:39:03.109000,0,0,1,1,4,0,1,5,0,0,1,1
2019-01-07 18:39:08.209000,1,2,2,5,0,0,4,4,0,0,1,1
2019-01-07 18:39:13.283000,2,0,3,5,3,1,3,7,0,0,2,2
2019-01-07 18:39:18.848000,0,0,2,2,3,1,1,5,0,0,0,0
2019-01-07 18:39:23.970000,3,0,3,6,3,1,2,6,0,0,0,0
2019-01-07 18:39:29.326000,1,1,2,4,1,2,4,7,0,0,0,0
2019-01-07 18:39:34.329000,4,2,5,11,3,2,5,10,0,0,0,0
2019-01-07 18:39:39.423000,1,0,4,5,1,0,1,2,0,0,1,1
2019-01-07 18:39:45.632000,0,1,2,3,2,1,3,6,0,0,2,2
2019-01-07 18:39:50.760000,0,1,2,3,1,3,4,8,0,0,1,1
2019-01-07 18:39:55.920000,1,0,2,3,4,1,0,5,0,0,1,1
2019-01-07 18:40:02.375000,2,1,4,7,2,3,2,7,0,0,0,0
2019-01-07 18:40:07.695000,1,0,4,5,1,1,2,4,0,0,1,1
2019-01-07 18:40:13.195000,4,3,1,8,2,1,4,7,0,0,2,2
2019-01-07 18:40:18.423000,2,0,1,3,1,1,2,4,0,0,0,0
2019-01-07 18:40:23.741000,0,1,3,4,2,0,8,10,0,0,0,0
2019-01-07 18:40:29.053000,0,1,3,4,0,0,2,2,0,0,0,0
2019-01-07 18:40:34.380000,2,1,2,5,2,0,2,4,0,0,0,0
2019-01-07 18:40:39.500000,2,0,2,4,1,1,3,5,0,0,0,0
2019-01-07 18:40:44.810000,3,1,2,6,3,0,4,7,0,0,0,0
2019-01-07 18:40:52.161000,0,1,4,5,0,0,2,2,0,0,1,1
2019-01-07 18:40:58.173000,2,0,1,3,4,4,3,11,0,0,0,0
2019-01-07 18:41:03.213000,0,1,2,3,2,1,2,5,0,0,0,0
2019-01-07 18:41:08.256000,2,0,5,7,0,1,5,6,0,0,1,1
2019-01-07 18:41:13.516000,2,1,0,3,1,0,2,3,0,0,0,0
2019-01-07 18:41:18.562000,2,0,3,5,1,2,3,6,0,0,0,0
2019-01-07 18:41:24.523000,1,0,0,1,3,2,2,7,0,0,0,0
2019-01-07 18:41:30.095000,1,3,2,6,0,1,4,5,0,0,0,0
2019-01-07 18:41:35.623000,3,1,5,9,4,1,1,6,0,0,0,0
2019-01-07 18:41:41.675000,4,0,0,4,1,1,5,7,0,0,1,1
2019-01-07 18:41:47.580000,0,1,1,2,4,0,2,6,0,1,1,2
2019-01-07 18:41:52.762000,2,0,2,4,3,1,1,5,0,0,0,0
2019-01-07 18:41:57.843000,4,0,3,7,1,3,0,4,0,0,2,2
2019-01-07 18:42:02.972000,2,0,3,5,0,1,5,6,0,0,0,0
2019-01-07 18:42:08.144000,2,0,2,4,4,0,3,7,0,0,1,1
2019-01-07 18:42:13.220000,0,0,3,3,5,3,4,12,0,0,0,0
2019-01-07 18:42:18.324000,0,2,1,3,2,0,6,8,0,0,0,0
2019-01-07 18:42:23.415000,1,1,2,4,2,0,1,3,0,0,2,2
2019-01-07 18:42:30.320000,1,0,3,4,6,0,1,7,0,0,0,0
2019-01-07 18:42:35.467000,1,0,3,4,2,2,0,4,0,0,1,1
2019-01-07 18:42:42.198000,2,1,2,5,3,2,2,7,0,0,1,1
2019-01-07 18:42:47.944000,1,1,1,3,0,1,4,5,0,0,1,1
2019-01-07 18:42:53.641000,2,0,0,2,6,0,3,9,0,0,1,1
2019-01-07 18:42:59.052000,1,3,1,5,1,0,4,5,0,0,0,0
2019-01-07 18:43:04.199000,2,0,5,7,2,1,6,9,0,0,2,2
2019-01-07 18:43:09.395000,3,0,1,4,2,0,2,4,0,0,0,0
2019-01-07 18:43:16.563000,1,0,2,3,2,2,3,7,0,0,1,1
2019-01-07 18:43:22.249000,1,2,1,4,1,0,5,6,0,0,0,0
2019-01-07 18:43:27.785000,3,0,1,4,1,0,4,5,0,0,1,1
2019-01-07 18:43:32.950000,0,0,2,2,2,0,2,4,0,0,1,1
2019-01-07 18:43:38.047000,0,0,2,2,0,1,3,4,0,0,2,2
2019-01-07 18:43:43.352000,1,0,2,3,1,0,1,2,0,0,0,0
2019-01-07 18:43:49.188000,2,0,7,9,5,1,3,9,0,0,1,1
2019-01-07 18:43:55.408000,2,0,6,8,4,0,5,9,0,0,2,2
2019-01-07 18:44:00.531000,3,1,5,9,4,0,2,6,0,0,0,0
2019-01-07 18:44:06.577000,1,0,3,4,1,0,4,5,0,0,0,0
2019-01-07 18:44:11.786000,3,1,4,8,3,0,3,6,0,0,0,0
2019-01-07 18:44:17.466000,3,0,4,7,1,2,4,7,0,0,0,0
2019-01-07 18:44:23.934000,0,0,3,3,3,1,4,8,0,0,0,0
2019-01-07 18:44:29.702000,1,0,2,3,1,1,0,2,0,0,1,1
2019-01-07 18:44:34.895000,1,2,1,4,5,4,2,11,0,0,1,1
2019-01-07 18:44:40.142000,2,1,3,6,1,0,6,7,0,0,0,0
2019-01-07 18:44:45.385000,3,0,4,7,4,1,3,8,0,0,1,1
2019-01-07 18:44:51.194000,1,0,3,4,1,0,6,7,0,0,3,3
2019-01-07 18:44:56.351000,4,1,1,6,0,0,3,3,0,0,0,0
2019-01-07 18:45:01.584000,1,0,5,6,2,1,5,8,0,0,0,0
2019-01-07 18:45:07.649000,1,1,4,6,0,2,3,5,0,0,0,0
2019-01-07 18:45:12.925000,0,0,3,3,5,0,2,7,0,0,0,0
2019-01-07 18:45:17.953000,1,0,2,3,3,1,5,9,0,0,1,1
2019-01-07 18:45:23.398000,0,0,4,4,5,1,2,8,0,0,1,1
2019-01-07 18:45:28.663000,1,2,1,4,0,2,4,6,0,0,0,0
2019-01-07 18:45:34.206000,0,1,5,6,1,0,4,5,0,0,0,0
2019-01-07 18:45:39.385000,0,0,1,1,2,0,6,8,0,0,2,2
2019-01-07 18:45:44.482000,2,1,0,3,1,3,9,13,0,0,1,1
2019-01-07 18:45:49.666000,1,0,2,3,1,1,3,5,0,0,0,0
2019-01-07 18:45:56.392000,1,0,6,7,0,0,2,2,0,0,1,1
2019-01-07 18:46:01.459000,1,0,0,1,1,1,4,6,0,0,1,1
2019-01-07 18:46:06.817000,3,0,4,7,3,0,8,11,0,0,0,0
2019-01-07 18:46:12.861000,1,0,2,3,4,0,0,4,0,0,0,0
2019-01-07 18:46:18.368000,0,0,4,4,2,3,4,9,0,0,0,0
2019-01-07 18:46:23.907000,0,1,4,5,2,0,3,5,0,0,1,1
2019-01-07 18:46:29.115000,2,1,2,5,4,0,8,12,0,0,0,0
2019-01-07 18:46:35.736000,2,2,2,6,4,1,3,8,0,0,1,1
2019-01-07 18:46:40.806000,3,0,1,4,7,0,5,12,0,0,1,1
2019-01-07 18:46:45.904000,0,0,1,1,5,0,2,7,0,0,0,0
2019-01-07 18:46:50.938000,2,0,4,6,2,0,5,7,0,0,1,1
2019-01-07 18:46:56.769000,1,2,2,5,1,1,3,5,0,0,1,1
2019-01-07 18:47:02.183000,1,0,0,1,1,0,2,3,0,0,0,0
2019-01-07 18:47:07.805000,3,2,1,6,2,0,0,2,0,0,2,2
2019-01-07 18:47:13.688000,2,0,2,4,5,1,4,10,0,0,1,1
2019-01-07 18:47:18.988000,2,1,1,4,1,1,3,5,0,0,1,1
2019-01-07 18:47:24.069000,1,0,2,3,1,3,6,10,0,0,2,2
2019-01-07 18:47:29.773000,5,0,2,7,5,3,4,12,0,0,0,0
2019-01-07 18:47:34.892000,4,0,0,4,2,1,4,7,0,0,1,1
2019-01-07 18:47:40.171000,3,1,2,6,2,0,4,6,0,0,0,0
2019-01-07 18:47:45.396000,6,3,5,14,0,1,2,3,0,0,3,3
2019-01-07 18:47:50.827000,2,0,1,3,2,2,3,7,0,0,0,0
2019-01-07 18:47:55.947000,0,2,2,4,3,1,9,13,0,0,0,0
2019-01-07 18:48:01.669000,2,1,2,5,4,3,4,11,0,0,1,1
2019-01-07 18:48:07.508000,2,0,4,6,3,1,4,8,0,0,0,0
2019-01-07 18:48:12.572000,1,1,2,4,3,2,4,9,0,0,0,0
2019-01-07 18:48:18.419000,0,0,5,5,5,1,6,12,0,0,2,2
2019-01-07 18:48:23.520000,0,0,2,2,1,3,4,8,0,0,0,0
2019-01-07 18:48:28.999000,1,0,3,4,6,2,4,12,0,0,0,0
2019-01-07 18:48:34.230000,2,0,2,4,2,0,3,5,1,0,0,1
2019-01-07 18:48:39.387000,2,2,1,5,3,1,2,6,0,0,1,1
2019-01-07 18:48:45.437000,0,0,7,7,2,1,8,11,0,0,0,0
2019-01-07 18:48:50.648000,2,1,1,4,4,0,2,6,1,0,0,1
2019-01-07 18:48:55.860000,3,1,1,5,2,0,2,4,0,0,0,0
2019-01-07 18:49:00.998000,0,1,3,4,6,2,5,13,0,0,0,0
2019-01-07 18:49:06.219000,2,1,2,5,4,2,4,10,0,0,0,0
2019-01-07 18:49:11.321000,1,1,3,5,2,1,2,5,0,0,0,0
2019-01-07 18:49:16.887000,0,1,0,1,3,2,3,8,0,0,2,2
2019-01-07 18:49:22.598000,1,1,1,3,2,1,5,8,0,0,0,0
2019-01-07 18:49:27.669000,2,1,0,3,5,0,4,9,0,0,0,0
2019-01-07 18:49:33.013000,1,0,5,6,0,2,6,8,0,0,1,1
2019-01-07 18:49:38.497000,0,2,3,5,5,2,3,10,0,0,1,1
2019-01-07 18:49:43.541000,3,1,0,4,2,2,0,4,0,0,0,0
2019-01-07 18:49:48.677000,1,2,1,4,8,0,4,12,0,0,1,1
2019-01-07 18:49:53.717000,1,0,2,3,3,4,5,12,0,0,1,1
2019-01-07 18:49:59.278000,0,0,4,4,0,0,2,2,0,0,0,0
2019-01-07 18:50:04.334000,1,0,2,3,2,1,2,5,1,0,0,1
2019-01-07 18:50:09.352000,1,1,3,5,1,1,4,6,0,0,0,0
2019-01-07 18:50:15.092000,2,0,3,5,4,0,2,6,0,0,2,2
2019-01-07 18:50:20.245000,1,1,4,6,2,0,3,5,0,0,1,1
2019-01-07 18:50:25.772000,2,0,4,6,1,1,10,12,0,0,0,0
2019-01-07 18:50:31.287000,2,0,0,2,4,1,2,7,1,0,0,1
2019-01-07 18:50:36.751000,2,0,1,3,2,1,1,4,1,0,0,1
2019-01-07 18:50:43.135000,2,0,3,5,2,0,2,4,0,0,1,1
2019-01-07 18:50:48.369000,2,0,1,3,2,0,4,6,0,0,2,2
2019-01-07 18:50:53.562000,2,2,1,5,1,3,3,7,0,0,0,0
2019-01-07 18:50:58.655000,1,0,0,1,0,0,2,2,0,0,2,2
2019-01-07 18:51:03.723000,2,0,1,3,4,1,2,7,0,0,0,0
2019-01-07 18:51:09.403000,0,1,1,2,5,0,4,9,0,0,1,1
2019-01-07 18:51:14.580000,1,0,1,2,0,1,7,8,0,0,1,1
2019-01-07 18:51:20.989000,3,1,4,8,3,2,3,8,0,0,0,0
2019-01-07 18:51:26.414000,1,1,3,5,2,0,10,12,0,0,2,2
2019-01-07 18:51:32.244000,1,1,1,3,1,0,3,4,0,0,0,0
2019-01-07 18:51:37.362000,0,0,3,3,2,0,2,4,0,0,0,0
2019-01-07 18:51:42.556000,2,0,3,5,1,1,2,4,0,0,1,1
2019-01-07 18:51:47.648000,0,0,1,1,2,2,6,10,0,0,2,2
2019-01-07 18:51:52.741000,0,0,4,4,2,0,5,7,0,0,1,1
2019-01-07 18:51:57.764000,2,1,2,5,3,1,7,11,0,0,1,1
2019-01-07 18:52:03.269000,1,0,0,1,4,1,3,8,0,0,2,2
2019-01-07 18:52:08.567000,2,0,2,4,2,0,2,4,0,0,2,2
2019-01-07 18:52:13.937000,3,0,2,5,5,1,3,9,0,0,0,0
2019-01-07 18:52:19.028000,2,1,0,3,0,1,2,3,0,0,1,1
2019-01-07 18:52:24.526000,3,0,6,9,1,2,6,9,0,0,0,0
2019-01-07 18:52:29.563000,1,0,1,2,1,1,2,4,0,0,1,1
2019-01-07 18:52:35.286000,5,0,1,6,0,2,4,6,0,0,1,1
2019-01-07 18:52:40.385000,0,1,1,2,3,2,6,11,0,0,1,1
2019-01-07 18:52:46.270000,0,0,0,0,2,2,1,5,0,0,1,1
2019-01-07 18:52:52.469000,2,0,3,5,4,0,3,7,1,0,0,1
2019-01-07 18:52:57.657000,1,2,1,4,2,0,5,7,0,0,0,0
2019-01-07 18:53:02.951000,2,2,2,6,5,3,6,14,0,0,0,0
2019-01-07 18:53:07.956000,1,0,2,3,3,2,4,9,0,0,1,1
2019-01-07 18:53:13.061000,2,3,4,9,5,1,1,7,0,0,1,1
2019-01-07 18:53:20.955000,1,0,5,6,1,1,3,5,0,0,0,0
2019-01-07 18:53:26.239000,1,0,1,2,5,1,5,11,0,0,1,1
2019-01-07 18:53:31.438000,4,0,5,9,5,1,2,8,0,0,0,0
2019-01-07 18:53:36.653000,3,0,3,6,4,0,3,7,0,0,1,1
2019-01-07 18:53:41.916000,2,2,3,7,1,1,3,5,0,0,0,0
2019-01-07 18:53:47.327000,0,0,5,5,3,1,4,8,0,0,1,1
2019-01-07 18:53:52.344000,2,0,2,4,2,1,0,3,0,0,1,1
2019-01-07 18:53:58.241000,1,1,1,3,5,0,5,10,0,0,0,0
2019-01-07 18:54:03.866000,2,0,1,3,4,0,5,9,0,0,0,0
2019-01-07 18:54:08.958000,1,0,3,4,5,2,4,11,0,0,0,0
2019-01-07 18:54:14.106000,1,2,2,5,2,0,4,6,0,0,1,1
2019-01-07 18:54:19.878000,0,0,2,2,3,0,3,6,0,0,0,0
2019-01-07 18:54:25.364000,1,1,3,5,3,0,7,10,0,0,0,0
2019-01-07 18:54:30.724000,0,0,3,3,5,1,6,12,0,0,0,0
2019-01-07 18:54:35.804000,3,0,2,5,3,1,3,7,0,0,2,2
2019-01-07 18:54:42.632000,1,2,2,5,2,1,3,6,0,0,0,0
2019-01-07 18:54:47.765000,1,0,6,7,3,2,4,9,0,0,1,1
2019-01-07 18:54:53.236000,3,1,3,7,1,0,6,7,0,0,0,0
2019-01-07 18:54:58.269000,2,2,5,9,1,1,4,6,0,0,1,1
2019-01-07 18:55:03.444000,2,2,1,5,4,2,4,10,0,0,0,0
2019-01-07 18:55:08.454000,3,0,0,3,3,2,3,8,0,0,0,0
2019-01-07 18:55:14.728000,1,0,1,2,5,1,2,8,0,0,0,0
2019-01-07 18:55:19.957000,2,0,3,5,3,1,4,8,0,0,0,0
2019-01-07 18:55:25.014000,1,0,1,2,3,1,2,6,0,0,1,1
2019-01-07 18:55:30.525000,0,0,2,2,4,2,7,13,0,0,1,1
2019-01-07 18:55:35.544000,2,1,4,7,2,1,3,6,0,0,0,0
2019-01-07 18:55:40.621000,1,0,2,3,2,0,3,5,0,0,0,0
2019-01-07 18:55:46.016000,3,2,2,7,2,2,2,6,0,0,0,0
2019-01-07 18:55:51.645000,3,0,3,6,2,2,3,7,0,0,3,3
2019-01-07 18:55:56.993000,3,1,1,5,5,0,4,9,0,0,1,1
2019-01-07 18:56:03.470000,0,2,2,4,1,2,3,6,0,0,0,0
2019-01-07 18:56:09.122000,3,0,2,5,1,1,2,4,0,0,0,0
2019-01-07 18:56:14.176000,0,0,4,4,3,0,4,7,0,0,1,1
2019-01-07 18:56:19.909000,1,0,1,2,1,2,4,7,0,0,1,1
2019-01-07 18:56:25.542000,2,2,1,5,1,2,6,9,0,0,0,0
2019-01-07 18:56:30.903000,2,1,5,8,0,1,6,7,0,0,0,0
2019-01-07 18:56:36.218000,5,0,1,6,1,1,4,6,0,0,0,0
2019-01-07 18:56:41.979000,0,0,0,0,2,1,5,8,0,0,0,0
2019-01-07 18:56:47.103000,2,2,1,5,4,1,3,8,0,0,1,1
2019-01-07 18:56:52.828000,1,1,1,3,1,2,4,7,0,0,1,1
2019-01-07 18:56:59.185000,2,1,2,5,2,0,4,6,0,0,1,1
2019-01-07 18:57:04.391000,2,1,1,4,2,1,2,5,0,0,2,2
2019-01-07 18:57:10.913000,0,4,3,7,0,2,2,4,0,0,1,1
2019-01-07 18:57:16.220000,3,2,5,10,2,2,3,7,0,0,0,0
2019-01-07 18:57:22.041000,1,1,2,4,2,2,0,4,0,0,1,1
2019-01-07 18:57:27.731000,2,1,5,8,2,2,0,4,0,0,1,1
2019-01-07 18:57:33.308000,2,1,2,5,0,0,5,5,0,0,0,0
2019-01-07 18:57:39.121000,1,0,4,5,5,1,5,11,0,0,2,2
2019-01-07 18:57:44.144000,0,2,4,6,2,2,3,7,0,0,2,2
2019-01-07 18:57:49.240000,0,1,2,3,3,0,2,5,0,0,0,0
2019-01-07 18:57:54.445000,2,1,2,5,2,1,3,6,0,0,0,0
2019-01-07 18:58:01.081000,4,0,4,8,3,1,5,9,0,0,2,2
2019-01-07 18:58:06.293000,1,0,4,5,0,2,3,5,0,0,0,0
2019-01-07 18:58:12.129000,1,0,4,5,6,0,1,7,0,0,0,0
2019-01-07 18:58:17.599000,2,1,4,7,7,2,2,11,0,0,0,0
2019-01-07 18:58:22.763000,2,0,1,3,1,1,1,3,0,0,0,0
2019-01-07 18:58:28.149000,1,0,2,3,3,1,7,11,0,0,2,2
2019-01-07 18:58:33.167000,2,2,3,7,3,0,6,9,0,0,1,1
2019-01-07 18:58:38.564000,0,0,1,1,3,1,4,8,0,0,1,1
2019-01-07 18:58:44.129000,0,0,1,1,2,0,3,5,0,0,0,0
2019-01-07 18:58:49.158000,4,2,1,7,1,1,4,6,0,0,0,0
2019-01-07 18:58:54.562000,3,2,2,7,4,1,5,10,0,0,1,1
2019-01-07 18:59:00.343000,0,1,0,1,3,0,4,7,0,0,1,1
2019-01-07 18:59:06.137000,1,1,4,6,1,1,6,8,0,0,0,0
2019-01-07 18:59:11.659000,1,1,4,6,1,0,5,6,0,0,0,0
2019-01-07 18:59:17.025000,4,0,2,6,0,0,3,3,0,0,0,0
2019-01-07 18:59:24.403000,1,0,2,3,5,3,8,16,0,0,0,0
2019-01-07 18:59:30.081000,1,1,3,5,2,1,5,8,0,0,1,1
2019-01-07 18:59:35.139000,1,2,1,4,6,2,3,11,0,0,1,1
2019-01-07 18:59:40.597000,3,1,1,5,2,0,1,3,0,0,3,3
2019-01-07 18:59:45.952000,2,0,1,3,2,0,2,4,0,0,0,0
2019-01-07 18:59:51.065000,1,1,2,4,2,1,4,7,0,0,1,1
2019-01-07 18:59:56.189000,3,1,5,9,1,1,1,3,0,0,0,0
2019-01-07 19:00:01.881000,2,0,3,5,3,1,1,5,0,0,0,0
2019-01-07 19:00:07.184000,3,0,1,4,1,1,2,4,0,0,1,1
2019-01-07 19:00:12.237000,3,0,2,5,1,2,5,8,0,0,1,1
2019-01-07 19:00:17.863000,2,1,1,4,7,0,6,13,0,0,0,0
2019-01-07 19:00:23.220000,2,1,4,7,3,1,6,10,0,0,0,0
2019-01-07 19:00:28.516000,1,0,1,2,2,1,3,6,0,0,1,1
2019-01-07 19:00:33.992000,2,1,3,6,3,1,4,8,1,0,0,1
2019-01-07 19:00:39.443000,1,1,3,5,3,0,4,7,0,0,0,0
2019-01-07 19:00:44.496000,0,0,1,1,5,0,8,13,0,0,0,0
2019-01-07 19:00:49.811000,3,0,2,5,2,2,3,7,0,0,0,0
2019-01-07 19:00:55.244000,1,1,3,5,3,0,1,4,0,0,0,0
2019-01-07 19:01:00.372000,0,1,2,3,1,2,3,6,0,0,2,2
2019-01-07 19:01:05.409000,1,1,0,2,2,2,4,8,0,0,0,0
2019-01-07 19:01:10.497000,2,0,2,4,3,2,3,8,0,0,0,0
2019-01-07 19:01:15.732000,3,1,2,6,1,0,3,4,0,0,0,0
2019-01-07 19:01:20.949000,3,1,1,5,0,1,7,8,0,0,1,1
2019-01-07 19:01:26.576000,1,1,4,6,1,0,14,15,0,0,2,2
2019-01-07 19:01:32.146000,0,1,3,4,2,2,4,8,0,0,0,0
2019-01-07 19:01:37.937000,1,1,6,8,2,0,3,5,0,0,0,0
2019-01-07 19:01:43.752000,1,1,1,3,1,1,5,7,0,0,0,0
2019-01-07 19:01:48.773000,3,0,2,5,2,1,3,6,0,0,0,0
2019-01-07 19:01:54.113000,1,2,4,7,6,0,2,8,0,0,0,0
2019-01-07 19:01:59.313000,3,0,0,3,2,2,8,12,0,0,0,0
2019-01-07 19:02:04.387000,1,0,0,1,2,1,2,5,0,0,2,2
2019-01-07 19:02:09.681000,1,1,3,5,2,0,6,8,0,0,0,0
2019-01-07 19:02:15.195000,3,0,3,6,3,1,4,8,0,0,2,2
2019-01-07 19:02:20.200000,1,2,1,4,2,4,3,9,0,0,0,0
2019-01-07 19:02:25.653000,0,0,1,1,0,1,3,4,0,0,1,1
2019-01-07 19:02:32.271000,3,2,3,8,1,0,13,14,0,0,2,2
2019-01-07 19:02:37.293000,4,0,1,5,7,0,2,9,0,0,0,0
2019-01-07 19:02:42.781000,2,0,0,2,1,3,7,11,1,0,0,1
2019-01-07 19:02:48.119000,1,0,1,2,8,2,2,12,0,0,2,2
2019-01-07 19:02:54.225000,1,0,1,2,1,0,2,3,0,0,0,0
2019-01-07 19:03:00.414000,2,0,3,5,2,0,4,6,0,0,2,2
2019-01-07 19:03:05.619000,2,0,1,3,4,1,2,7,0,0,2,2
2019-01-07 19:03:12.549000,0,1,3,4,3,1,5,9,0,0,0,0
2019-01-07 19:03:17.901000,2,0,2,4,4,1,2,7,0,0,0,0
2019-01-07 19:03:23.398000,2,1,4,7,1,0,2,3,0,0,2,2
2019-01-07 19:03:28.866000,2,0,1,3,3,1,4,8,0,0,1,1
2019-01-07 19:03:34.328000,3,0,3,6,2,0,1,3,0,0,1,1
2019-01-07 19:03:41.257000,0,3,2,5,5,1,1,7,0,0,0,0
2019-01-07 19:03:46.630000,3,1,4,8,4,0,3,7,0,0,1,1
2019-01-07 19:03:51.950000,0,0,2,2,1,2,2,5,0,0,0,0
2019-01-07 19:03:56.993000,1,1,3,5,1,2,6,9,0,0,1,1
2019-01-07 19:04:02.567000,2,1,3,6,0,1,4,5,0,0,0,0
2019-01-07 19:04:07.581000,3,0,3,6,7,0,3,10,0,0,0,0
2019-01-07 19:04:13.329000,2,0,1,3,5,1,5,11,0,0,0,0
2019-01-07 19:04:18.534000,1,0,3,4,1,2,3,6,0,0,0,0
2019-01-07 19:04:23.629000,2,1,2,5,1,0,4,5,0,0,0,0
2019-01-07 19:04:28.647000,0,0,1,1,4,0,11,15,0,0,2,2
2019-01-07 19:04:33.873000,1,0,4,5,4,2,1,7,0,0,0,0
2019-01-07 19:04:39.475000,1,0,5,6,1,1,7,9,0,0,0,0
2019-01-07 19:04:46.621000,2,0,2,4,3,3,5,11,0,0,0,0
2019-01-07 19:04:51.716000,2,0,3,5,1,1,5,7,0,0,0,0
2019-01-07 19:04:57.728000,0,1,4,5,0,2,0,2,0,0,0,0
2019-01-07 19:05:02.839000,0,1,1,2,0,0,4,4,0,0,0,0
2019-01-07 19:05:08.436000,0,0,1,1,2,0,7,9,0,0,1,1
2019-01-07 19:05:13.618000,6,1,4,11,6,1,5,12,0,0,2,2
2019-01-07 19:05:19.403000,1,0,2,3,1,3,3,7,0,0,0,0
2019-01-07 19:05:24.541000,2,0,2,4,2,1,1,4,0,0,0,0
2019-01-07 19:05:29.629000,1,1,1,3,2,1,0,3,0,0,0,0
2019-01-07 19:05:34.828000,2,2,3,7,4,1,2,7,0,0,0,0
2019-01-07 19:05:40.219000,3,0,3,6,0,3,0,3,0,0,1,1
2019-01-07 19:05:45.499000,0,0,7,7,1,2,4,7,0,0,1,1
2019-01-07 19:05:50.709000,0,1,2,3,2,1,2,5,0,0,0,0
2019-01-07 19:05:55.849000,1,1,2,4,0,1,3,4,1,0,0,1
2019-01-07 19:06:01.158000,0,1,2,3,2,0,1,3,0,0,0,0
2019-01-07 19:06:06.561000,0,1,4,5,3,2,5,10,0,0,2,2
2019-01-07 19:06:11.611000,1,0,2,3,3,1,4,8,0,0,2,2
2019-01-07 19:06:16.734000,3,1,2,6,2,0,3,5,0,0,1,1
2019-01-07 19:06:23.073000,2,0,1,3,2,0,3,5,0,0,1,1
2019-01-07 19:06:28.369000,2,1,2,5,2,0,3,5,0,0,1,1
2019-01-07 19:06:33.554000,3,2,2,7,4,1,0,5,0,0,0,0
2019-01-07 19:06:38.845000,3,0,2,5,2,2,3,7,0,0,0,0
2019-01-07 19:06:44.425000,3,0,4,7,1,0,2,3,0,0,1,1
2019-01-07 19:06:49.913000,0,0,5,5,1,0,3,4,0,0,0,0
2019-01-07 19:06:55.130000,1,1,4,6,2,0,3,5,0,0,1,1
2019-01-07 19:07:00.134000,3,2,0,5,4,0,2,6,0,0,1,1
2019-01-07 19:07:05.387000,2,1,1,4,1,1,6,8,0,0,1,1
2019-01-07 19:07:10.502000,1,1,4,6,3,2,3,8,0,0,0,0
2019-01-07 19:07:15.757000,3,0,1,4,1,0,2,3,0,1,0,1
2019-01-07 19:07:20.795000,2,1,3,6,2,2,8,12,0,0,1,1
2019-01-07 19:07:27.089000,1,1,3,5,3,1,4,8,0,0,0,0
2019-01-07 19:07:32.833000,3,1,4,8,4,0,1,5,0,0,0,0
2019-01-07 19:07:38.096000,0,0,3,3,5,0,5,10,0,0,1,1
2019-01-07 19:07:43.571000,2,3,2,7,1,0,5,6,0,0,1,1
2019-01-07 19:07:48.914000,2,2,2,6,3,4,2,9,0,0,1,1
2019-01-07 19:07:54.346000,3,0,1,4,1,0,2,3,0,0,1,1
2019-01-07 19:07:59.461000,0,2,0,2,2,1,2,5,0,0,0,0
2019-01-07 19:08:04.944000,1,1,4,6,3,0,1,4,0,0,1,1
2019-01-07 19:08:10.178000,2,0,2,4,2,3,2,7,0,0,0,0
2019-01-07 19:08:15.628000,0,0,5,5,1,3,3,7,0,0,0,0
2019-01-07 19:08:20.705000,1,1,2,4,1,1,4,6,0,0,0,0
2019-01-07 19:08:26.401000,1,0,1,2,2,0,5,7,0,0,1,1
2019-01-07 19:08:32.575000,1,0,3,4,0,2,1,3,0,0,2,2
2019-01-07 19:08:39.856000,0,1,3,4,4,1,3,8,0,0,0,0
2019-01-07 19:08:45.004000,0,0,0,0,0,0,3,3,0,0,2,2
2019-01-07 19:08:50.048000,6,0,1,7,3,1,2,6,0,0,0,0
2019-01-07 19:08:55.914000,0,0,2,2,3,1,4,8,0,0,0,0
2019-01-07 19:09:01.199000,0,0,3,3,1,0,3,4,0,0,0,0
2019-01-07 19:09:06.388000,1,1,2,4,3,1,5,9,0,0,1,1
2019-01-07 19:09:11.838000,2,0,2,4,1,1,5,7,0,0,2,2
2019-01-07 19:09:16.862000,2,0,1,3,2,2,4,8,0,0,1,1
2019-01-07 19:09:22.044000,3,2,1,6,2,0,4,6,0,0,2,2
2019-01-07 19:09:27.337000,2,0,1,3,4,1,2,7,0,0,0,0
2019-01-07 19:09:32.429000,2,1,4,7,5,0,5,10,0,0,0,0
2019-01-07 19:09:37.717000,1,1,4,6,3,3,5,11,0,0,1,1
2019-01-07 19:09:42.808000,1,1,1,3,0,1,6,7,0,0,1,1
2019-01-07 19:09:48.353000,1,0,3,4,1,0,1,2,0,0,2,2
2019-01-07 19:09:53.527000,2,0,5,7,1,1,4,6,0,0,1,1
2019-01-07 19:09:59.146000,5,2,2,9,4,0,0,4,0,0,0,0
2019-01-07 19:10:04.779000,1,1,2,4,6,1,0,7,0,0,0,0
2019-01-07 19:10:10.377000,2,1,3,6,1,0,4,5,0,0,0,0
2019-01-07 19:10:17.752000,0,0,1,1,2,2,4,8,0,0,2,2
2019-01-07 19:10:22.985000,2,0,0,2,5,0,3,8,0,0,0,0
2019-01-07 19:10:28.458000,0,2,3,5,1,0,4,5,0,0,0,0
2019-01-07 19:10:33.675000,4,0,4,8,3,1,5,9,0,0,1,1
2019-01-07 19:10:39.446000,0,0,1,1,1,3,4,8,0,0,0,0
2019-01-07 19:10:44.549000,2,0,3,5,3,2,3,8,0,0,0,0
2019-01-07 19:10:50.564000,2,1,1,4,2,3,3,8,0,0,0,0
2019-01-07 19:10:56.090000,3,0,1,4,3,0,4,7,0,0,1,1
2019-01-07 19:11:01.195000,2,1,2,5,1,0,2,3,0,0,0,0
2019-01-07 19:11:06.444000,1,0,1,2,5,1,3,9,0,0,0,0
2019-01-07 19:11:11.545000,9,1,2,12,0,1,5,6,0,1,0,1
2019-01-07 19:11:16.907000,0,1,2,3,1,1,3,5,0,0,0,0
2019-01-07 19:11:23.142000,2,1,2,5,3,0,6,9,0,0,1,1
2019-01-07 19:11:28.528000,1,1,3,5,4,2,3,9,0,0,1,1
2019-01-07 19:11:33.530000,1,0,1,2,1,0,2,3,0,0,0,0
2019-01-07 19:11:39.323000,2,1,1,4,2,1,5,8,0,0,1,1
2019-01-07 19:11:46.299000,4,1,9,14,3,0,2,5,0,0,0,0
2019-01-07 19:11:51.792000,4,2,2,8,5,1,5,11,0,0,0,0
2019-01-07 19:11:57.054000,2,0,3,5,4,0,3,7,0,0,0,0
2019-01-07 19:12:02.446000,2,0,4,6,3,2,1,6,0,0,2,2
2019-01-07 19:12:07.699000,0,0,3,3,1,0,5,6,0,0,0,0
2019-01-07 19:12:13.420000,1,0,4,5,5,0,1,6,0,0,0,0
2019-01-07 19:12:18.718000,2,0,3,5,1,0,3,4,0,0,2,2
2019-01-07 19:12:23.848000,3,0,2,5,2,0,3,5,0,0,0,0
2019-01-07 19:12:29.592000,1,2,4,7,3,1,1,5,0,0,0,0
2019-01-07 19:12:34.902000,2,0,4,6,2,1,5,8,0,0,0,0
2019-01-07 19:12:40,1,1,2,4,2,0,3,5,0,0,0,0
2019-01-07 19:12:45.310000,2,3,2,7,0,0,1,1,0,0,2,2
2019-01-07 19:12:50.594000,3,0,3,6,3,0,0,3,0,0,0,0
2019-01-07 19:12:56.736000,2,1,5,8,1,0,5,6,0,0,1,1
2019-01-07 19:13:03.050000,0,0,1,1,5,0,3,8,0,0,0,0
2019-01-07 19:13:08.104000,1,0,2,3,3,2,3,8,0,0,0,0
2019-01-07 19:13:14.372000,1,0,1,2,5,0,3,8,0,0,1,1
2019-01-07 19:13:19.475000,1,0,0,1,5,0,3,8,0,0,0,0
2019-01-07 19:13:24.966000,0,0,3,3,0,1,7,8,0,0,0,0
2019-01-07 19:13:29.978000,1,1,5,7,2,1,3,6,0,0,1,1
2019-01-07 19:13:35.349000,0,1,3,4,5,1,3,9,0,0,0,0
2019-01-07 19:13:40.699000,2,2,2,6,1,1,3,5,0,0,1,1
2019-01-07 19:13:46.787000,1,1,1,3,1,3,3,7,0,2,0,2
2019-01-07 19:13:52.375000,1,1,1,3,1,1,8,10,0,0,1,1
2019-01-07 19:13:57.773000,0,0,2,2,4,0,2,6,0,0,1,1
2019-01-07 19:14:02.886000,4,0,5,9,7,0,1,8,0,0,0,0
2019-01-07 19:14:08.021000,1,1,3,5,2,2,3,7,0,0,0,0
2019-01-07 19:14:13.132000,1,1,0,2,1,5,6,12,0,0,0,0
2019-01-07 19:14:18.589000,0,3,1,4,2,2,2,6,0,0,0,0
2019-01-07 19:14:23.751000,2,2,1,5,1,3,4,8,0,0,0,0
2019-01-07 19:14:28.753000,2,0,1,3,2,0,2,4,0,0,1,1
2019-01-07 19:14:34.278000,2,1,4,7,0,1,5,6,0,0,0,0
2019-01-07 19:14:41.050000,2,0,1,3,5,2,3,10,0,0,0,0
2019-01-07 19:14:46.198000,1,1,0,2,2,1,4,7,0,0,3,3
2019-01-07 19:14:51.388000,0,0,2,2,4,1,3,8,0,0,0,0
2019-01-07 19:14:56.685000,1,0,5,6,3,1,0,4,0,0,0,0
2019-01-07 19:15:02.851000,1,0,2,3,1,0,2,3,0,0,0,0
2019-01-07 19:15:08.066000,0,1,4,5,7,2,2,11,0,0,1,1
2019-01-07 19:15:13.490000,3,0,3,6,4,0,3,7,0,0,2,2
2019-01-07 19:15:18.547000,1,0,0,1,1,2,3,6,0,0,1,1
2019-01-07 19:15:23.925000,1,0,5,6,2,1,4,7,0,0,1,1
2019-01-07 19:15:29.375000,3,2,0,5,2,1,6,9,0,0,1,1
2019-01-07 19:15:34.396000,2,0,1,3,2,2,5,9,0,0,1,1
2019-01-07 19:15:40.091000,1,0,4,5,0,2,5,7,1,0,0,1
2019-01-07 19:15:45.196000,2,1,3,6,1,0,3,4,0,0,1,1
2019-01-07 19:15:51.309000,2,1,0,3,1,1,9,11,0,0,0,0
2019-01-07 19:15:57.772000,2,1,0,3,2,1,2,5,0,0,1,1
2019-01-07 19:16:03.458000,3,0,3,6,3,1,0,4,0,0,0,0
2019-01-07 19:16:08.745000,1,1,3,5,2,1,3,6,0,0,3,3
2019-01-07 19:16:13.873000,2,0,2,4,3,0,2,5,0,0,2,2
2019-01-07 19:16:19.931000,0,0,2,2,3,0,5,8,0,0,1,1
2019-01-07 19:16:25.762000,2,0,1,3,3,2,4,9,0,0,2,2
2019-01-07 19:16:31.156000,2,2,0,4,3,1,1,5,0,0,0,0
2019-01-07 19:16:36.179000,2,0,2,4,7,1,2,10,0,0,1,1
2019-01-07 19:16:41.239000,3,1,3,7,0,1,1,2,0,0,0,0
2019-01-07 19:16:46.425000,2,1,1,4,3,1,5,9,0,0,1,1
2019-01-07 19:16:51.695000,3,0,2,5,1,0,2,3,0,0,1,1
2019-01-07 19:16:57.971000,3,0,4,7,1,1,3,5,0,0,0,0
2019-01-07 19:17:03.279000,4,1,0,5,2,0,5,7,0,0,0,0
2019-01-07 19:17:08.381000,2,0,1,3,3,0,3,6,0,0,0,0
2019-01-07 19:17:13.636000,1,0,3,4,5,1,1,7,0,0,0,0
2019-01-07 19:17:18.928000,1,1,4,6,4,2,4,10,0,0,0,0
2019-01-07 19:17:24.049000,1,0,3,4,2,2,8,12,0,0,1,1
2019-01-07 19:17:29.113000,0,2,3,5,2,0,1,3,0,0,0,0
2019-01-07 19:17:35.076000,1,0,2,3,1,0,3,4,0,0,0,0
2019-01-07 19:17:40.285000,1,0,3,4,1,1,3,5,0,0,1,1
2019-01-07 19:17:45.409000,0,1,7,8,3,1,4,8,0,0,1,1
2019-01-07 19:17:50.939000,0,1,4,5,2,1,3,6,0,0,0,0
2019-01-07 19:17:56.034000,2,1,4,7,4,0,5,9,0,0,0,0
2019-01-07 19:18:01.245000,2,1,1,4,2,1,4,7,0,0,0,0
2019-01-07 19:18:08.566000,3,0,5,8,3,4,2,9,0,1,1,2
2019-01-07 19:18:13.794000,1,1,2,4,3,0,3,6,0,0,1,1
2019-01-07 19:18:19.066000,1,0,4,5,1,1,5,7,0,0,1,1
2019-01-07 19:18:24.683000,3,0,2,5,1,0,3,4,0,0,0,0
2019-01-07 19:18:30.689000,2,1,1,4,3,0,3,6,0,0,1,1
2019-01-07 19:18:35.895000,0,0,2,2,4,0,1,5,0,0,1,1
2019-01-07 19:18:41.559000,0,0,5,5,4,0,5,9,0,0,0,0
2019-01-07 19:18:46.709000,1,0,3,4,1,0,2,3,0,0,1,1
2019-01-07 19:18:51.999000,3,3,5,11,2,0,5,7,0,0,0,0
2019-01-07 19:18:57.104000,1,0,2,3,1,0,2,3,0,0,0,0
2019-01-07 19:19:02.185000,3,0,3,6,1,0,3,4,0,0,0,0
2019-01-07 19:19:07.800000,2,0,3,5,2,2,2,6,0,0,5,5
2019-01-07 19:19:13.009000,3,0,2,5,2,1,6,9,0,0,1,1
2019-01-07 19:19:18.379000,1,1,3,5,2,1,1,4,0,0,0,0
2019-01-07 19:19:23.443000,2,2,4,8,3,0,4,7,0,0,0,0
2019-01-07 19:19:28.720000,0,0,4,4,0,1,2,3,0,0,1,1
2019-01-07 19:19:34.194000,4,0,3,7,1,0,2,3,0,0,0,0
2019-01-07 19:19:39.930000,2,1,1,4,1,1,7,9,0,0,0,0
2019-01-07 19:19:45.932000,1,1,1,3,1,0,2,3,0,0,1,1
2019-01-07 19:19:50.958000,2,0,6,8,2,0,1,3,0,0,0,0
2019-01-07 19:19:56.129000,1,0,2,3,3,1,3,7,0,1,0,1
2019-01-07 19:20:01.539000,3,2,1,6,2,1,5,8,0,0,1,1
2019-01-07 19:20:06.737000,0,0,3,3,1,0,6,7,0,0,1,1
2019-01-07 19:20:12.048000,1,1,4,6,2,0,1,3,0,0,1,1
2019-01-07 19:20:18.190000,4,0,0,4,3,1,1,5,0,0,1,1
2019-01-07 19:20:23.366000,2,0,1,3,4,0,4,8,0,0,1,1
2019-01-07 19:20:28.841000,0,0,3,3,2,0,6,8,0,0,1,1
2019-01-07 19:20:34.059000,1,0,2,3,3,4,9,16,0,0,1,1
2019-01-07 19:20:39.145000,0,0,2,2,3,1,8,12,0,0,0,0
2019-01-07 19:20:44.715000,2,1,2,5,2,0,4,6,0,0,0,0
2019-01-07 19:20:51.147000,3,0,3,6,2,0,2,4,0,0,1,1
2019-01-07 19:20:57.688000,3,1,3,7,2,0,5,7,0,0,0,0
2019-01-07 19:21:03.352000,1,1,3,5,0,0,3,3,0,0,0,0
2019-01-07 19:21:10.117000,4,1,1,6,1,1,1,3,0,0,1,1
2019-01-07 19:21:15.299000,0,0,3,3,2,1,5,8,0,0,2,2
2019-01-07 19:21:20.628000,5,0,1,6,1,0,3,4,0,0,0,0
2019-01-07 19:21:26.548000,1,1,1,3,0,1,10,11,0,0,0,0
2019-01-07 19:21:32.014000,1,0,3,4,4,2,4,10,0,0,0,0
2019-01-07 19:21:37.298000,1,1,5,7,1,0,3,4,0,0,1,1
2019-01-07 19:21:42.344000,3,0,1,4,2,0,4,6,0,0,0,0
2019-01-07 19:21:48.108000,0,1,1,2,1,0,6,7,0,0,0,0
2019-01-07 19:21:53.628000,0,1,6,7,1,0,3,4,0,0,0,0
2019-01-07 19:21:58.646000,1,0,1,2,2,0,3,5,0,0,1,1
2019-01-07 19:22:03.867000,2,0,0,2,1,2,2,5,0,0,0,0
2019-01-07 19:22:09.926000,0,0,1,1,3,0,1,4,0,0,0,0
2019-01-07 19:22:15.210000,0,1,4,5,2,0,5,7,0,0,1,1
2019-01-07 19:22:20.838000,2,0,3,5,3,0,8,11,0,0,0,0
2019-01-07 19:22:26.636000,1,0,4,5,3,2,3,8,0,0,0,0
2019-01-07 19:22:31.988000,1,1,2,4,1,2,2,5,0,0,0,0
2019-01-07 19:22:37.692000,2,1,1,4,2,2,5,9,0,0,0,0
2019-01-07 19:22:42.819000,1,1,3,5,0,1,2,3,0,0,0,0
2019-01-07 19:22:48.124000,1,0,3,4,5,1,3,9,0,0,0,0
2019-01-07 19:22:54.102000,1,1,3,5,4,0,2,6,0,0,1,1
2019-01-07 19:22:59.290000,2,0,3,5,2,1,1,4,0,0,0,0
2019-01-07 19:23:04.814000,0,1,3,4,6,1,4,11,0,0,1,1
2019-01-07 19:23:09.862000,1,0,2,3,3,0,5,8,0,0,0,0
2019-01-07 19:23:15.009000,2,0,1,3,4,1,1,6,0,0,0,0
2019-01-07 19:23:20.394000,2,1,7,10,2,2,0,4,0,0,0,0
2019-01-07 19:23:26.755000,3,0,0,3,3,0,5,8,0,0,0,0
2019-01-07 19:23:31.772000,3,3,2,8,2,0,7,9,0,0,1,1
2019-01-07 19:23:37.912000,3,0,1,4,2,1,2,5,0,0,0,0
2019-01-07 19:23:43.176000,4,0,1,5,1,0,4,5,0,0,0,0
2019-01-07 19:23:48.685000,2,0,2,4,1,0,2,3,0,0,0,0
2019-01-07 19:23:54.639000,3,0,3,6,0,1,5,6,0,0,2,2
2019-01-07 19:23:59.779000,0,0,2,2,1,1,3,5,0,0,0,0
2019-01-07 19:24:04.877000,2,1,2,5,4,1,4,9,0,0,1,1
2019-01-07 19:24:10.428000,1,1,1,3,2,1,0,3,0,0,0,0
2019-01-07 19:24:16.163000,1,0,6,7,3,1,3,7,0,0,2,2
2019-01-07 19:24:21.313000,5,0,0,5,2,0,6,8,0,0,2,2
2019-01-07 19:24:26.726000,2,0,2,4,1,2,2,5,0,0,1,1
2019-01-07 19:24:32,2,0,3,5,1,2,5,8,0,0,2,2
2019-01-07 19:24:37.421000,3,1,3,7,5,1,1,7,0,0,2,2
2019-01-07 19:24:43.665000,2,1,3,6,2,1,1,4,0,0,3,3
2019-01-07 19:24:48.891000,1,1,3,5,1,1,1,3,0,0,2,2
2019-01-07 19:24:53.974000,1,0,3,4,0,2,4,6,0,0,1,1
2019-01-07 19:24:59.464000,3,0,4,7,3,2,4,9,0,0,3,3
2019-01-07 19:25:04.964000,0,1,1,2,2,1,0,3,1,0,4,5
2019-01-07 19:25:10.062000,0,1,4,5,2,0,5,7,0,0,3,3
2019-01-07 19:25:16.103000,4,1,6,11,3,0,5,8,0,0,0,0
2019-01-07 19:25:21.366000,2,0,6,8,0,0,1,1,0,0,0,0
2019-01-07 19:25:27.164000,1,1,0,2,0,0,4,4,0,0,1,1
2019-01-07 19:25:32.600000,2,0,1,3,1,0,5,6,0,0,0,0
2019-01-07 19:25:38.086000,1,1,4,6,2,1,4,7,0,0,0,0
2019-01-07 19:25:43.144000,2,0,1,3,1,1,2,4,0,0,0,0
2019-01-07 19:25:48.413000,1,1,2,4,4,0,5,9,0,0,0,0
2019-01-07 19:25:54.397000,2,0,4,6,1,1,3,5,0,0,2,2
2019-01-07 19:25:59.774000,3,1,3,7,1,1,1,3,0,0,0,0
2019-01-07 19:26:06.284000,1,2,3,6,0,1,1,2,0,0,0,0
2019-01-07 19:26:11.465000,1,0,1,2,1,0,9,10,0,0,2,2
2019-01-07 19:26:16.873000,1,2,3,6,1,0,3,4,0,0,1,1
2019-01-07 19:26:21.899000,2,1,4,7,2,0,2,4,0,0,0,0
2019-01-07 19:26:27.306000,0,0,5,5,5,1,5,11,0,0,4,4
2019-01-07 19:26:32.572000,2,2,2,6,3,3,2,8,0,1,1,2
2019-01-07 19:26:37.805000,2,2,2,6,0,1,2,3,0,0,1,1
2019-01-07 19:26:43.305000,3,0,1,4,4,1,1,6,0,0,0,0
2019-01-07 19:26:48.387000,2,2,2,6,6,0,7,13,0,0,0,0
2019-01-07 19:26:53.998000,0,0,2,2,4,0,3,7,0,0,0,0
2019-01-07 19:26:59.637000,3,1,1,5,2,0,0,2,0,0,1,1
2019-01-07 19:27:05.001000,2,0,3,5,3,0,2,5,0,0,1,1
2019-01-07 19:27:10.317000,3,0,2,5,3,0,3,6,0,1,0,1
2019-01-07 19:27:16.025000,0,0,5,5,2,1,0,3,0,0,0,0
2019-01-07 19:27:21.546000,2,0,3,5,1,3,3,7,0,0,0,0
2019-01-07 19:27:26.736000,1,0,4,5,1,0,3,4,0,0,0,0
2019-01-07 19:27:32.717000,2,0,3,5,6,0,3,9,0,0,1,1
2019-01-07 19:27:38.273000,1,0,2,3,0,1,1,2,0,0,0,0
2019-01-07 19:27:43.287000,2,0,2,4,1,0,6,7,0,0,1,1
2019-01-07 19:27:48.336000,2,0,1,3,2,0,3,5,0,0,0,0
2019-01-07 19:27:53.478000,2,0,1,3,2,0,6,8,0,0,1,1
2019-01-07 19:27:58.681000,4,0,0,4,1,0,2,3,0,0,1,1
2019-01-07 19:28:03.707000,1,0,3,4,2,2,0,4,0,0,1,1
2019-01-07 19:28:09.592000,0,0,5,5,5,0,4,9,0,0,1,1
2019-01-07 19:28:16.444000,4,1,3,8,5,0,3,8,0,0,0,0
2019-01-07 19:28:22.375000,4,0,1,5,1,1,4,6,0,0,2,2
2019-01-07 19:28:27.656000,3,1,1,5,2,1,2,5,0,0,0,0
2019-01-07 19:28:32.726000,1,1,2,4,3,0,2,5,0,0,0,0
2019-01-07 19:28:38.542000,1,0,3,4,2,0,3,5,0,0,0,0
2019-01-07 19:28:43.592000,1,1,4,6,2,0,5,7,0,0,0,0
2019-01-07 19:28:48.608000,1,0,2,3,5,2,6,13,0,0,1,1
2019-01-07 19:28:54.859000,2,0,2,4,6,0,1,7,0,0,1,1
2019-01-07 19:29:00.291000,2,0,2,4,3,1,2,6,0,0,1,1
2019-01-07 19:29:05.625000,0,0,5,5,3,0,7,10,0,0,0,0
2019-01-07 19:29:10.834000,2,1,3,6,1,1,8,10,0,0,0,0
2019-01-07 19:29:16.094000,2,0,3,5,2,1,2,5,0,0,0,0
2019-01-07 19:29:21.313000,2,1,7,10,3,3,3,9,0,0,2,2
2019-01-07 19:29:26.583000,0,0,5,5,2,1,4,7,1,0,0,1
2019-01-07 19:29:32.091000,1,0,2,3,3,1,5,9,0,0,0,0
2019-01-07 19:29:37.984000,0,2,1,3,4,0,2,6,0,0,1,1
2019-01-07 19:29:43.291000,0,3,5,8,2,1,4,7,0,0,0,0
2019-01-07 19:29:48.611000,1,1,3,5,2,0,4,6,0,0,0,0
2019-01-07 19:29:54.773000,2,1,2,5,4,1,3,8,0,0,0,0
2019-01-07 19:30:00.020000,2,0,3,5,2,1,6,9,0,0,0,0
2019-01-07 19:30:05.270000,2,1,5,8,3,0,3,6,0,0,0,0
2019-01-07 19:30:10.289000,4,2,3,9,1,1,4,6,0,0,0,0
2019-01-07 19:30:15.567000,5,0,3,8,5,0,2,7,0,0,0,0
2019-01-07 19:30:20.803000,3,1,3,7,0,0,2,2,0,0,0,0
2019-01-07 19:30:27.129000,2,1,4,7,2,0,4,6,0,0,1,1
2019-01-07 19:30:33.303000,2,0,3,5,4,0,2,6,0,0,1,1
2019-01-07 19:30:39.126000,1,1,5,7,0,2,2,4,0,0,3,3
2019-01-07 19:30:44.541000,0,0,3,3,3,1,2,6,0,0,0,0
2019-01-07 19:30:50.342000,0,1,1,2,3,0,3,6,0,0,2,2
2019-01-07 19:30:55.402000,1,0,0,1,2,1,4,7,0,0,0,0
2019-01-07 19:31:00.485000,0,1,3,4,3,0,7,10,0,0,0,0
2019-01-07 19:31:05.942000,0,1,3,4,2,0,5,7,0,0,0,0
2019-01-07 19:31:11.415000,1,0,2,3,3,1,3,7,0,0,0,0
2019-01-07 19:31:17.097000,0,0,1,1,2,1,1,4,0,0,1,1
2019-01-07 19:31:22.282000,3,1,4,8,2,0,2,4,0,0,0,0
2019-01-07 19:31:27.941000,1,0,0,1,0,2,11,13,0,0,0,0
2019-01-07 19:31:34.697000,2,0,2,4,2,2,2,6,0,0,0,0
2019-01-07 19:31:40.904000,4,1,2,7,0,0,6,6,0,0,1,1
2019-01-07 19:31:45.910000,1,1,2,4,0,3,4,7,0,0,2,2
2019-01-07 19:31:51.254000,0,1,1,2,1,1,3,5,0,0,1,1
2019-01-07 19:31:56.329000,0,0,0,0,1,1,3,5,0,0,1,1
2019-01-07 19:32:01.671000,1,0,1,2,3,0,2,5,0,0,2,2
2019-01-07 19:32:07.068000,1,1,5,7,0,2,1,3,0,0,1,1
2019-01-07 19:32:12.380000,2,0,2,4,2,0,1,3,0,0,0,0
2019-01-07 19:32:17.716000,2,1,3,6,3,1,1,5,0,0,1,1
2019-01-07 19:32:22.919000,2,0,4,6,2,5,8,15,0,0,1,1
2019-01-07 19:32:28.437000,4,1,1,6,3,1,3,7,0,0,0,0
2019-01-07 19:32:33.751000,4,0,1,5,2,3,2,7,0,0,0,0
2019-01-07 19:32:40.049000,0,1,2,3,4,1,5,10,0,0,1,1
2019-01-07 19:32:45.644000,3,2,3,8,1,1,2,4,0,0,1,1
2019-01-07 19:32:51.729000,1,0,4,5,4,1,2,7,0,0,1,1
2019-01-07 19:32:57.444000,2,0,3,5,5,0,1,6,0,0,0,0
2019-01-07 19:33:02.780000,1,1,2,4,0,0,1,1,0,0,0,0
2019-01-07 19:33:07.815000,1,0,3,4,2,1,1,4,0,0,0,0
2019-01-07 19:33:12.874000,2,0,3,5,1,0,3,4,0,0,0,0
2019-01-07 19:33:18.083000,1,0,2,3,3,0,3,6,0,0,0,0
2019-01-07 19:33:24.706000,2,0,2,4,2,1,5,8,0,0,0,0
2019-01-07 19:33:31.500000,2,1,1,4,0,1,6,7,0,0,1,1
2019-01-07 19:33:36.833000,0,0,4,4,2,1,4,7,0,0,2,2
2019-01-07 19:33:42.211000,1,0,4,5,1,1,5,7,0,0,0,0
2019-01-07 19:33:47.702000,2,1,7,10,0,1,3,4,0,0,1,1
2019-01-07 19:33:53.204000,2,0,3,5,3,0,5,8,0,0,0,0
2019-01-07 19:33:58.324000,0,0,3,3,3,1,4,8,0,0,0,0
2019-01-07 19:34:03.797000,1,1,2,4,2,1,3,6,0,0,0,0
2019-01-07 19:34:08.861000,2,0,5,7,2,1,3,6,0,0,1,1
2019-01-07 19:34:15.449000,1,0,0,1,2,0,7,9,0,0,3,3
2019-01-07 19:34:20.678000,1,0,4,5,1,0,5,6,0,0,0,0
2019-01-07 19:34:26.492000,1,3,5,9,4,2,2,8,0,0,2,2
2019-01-07 19:34:32.194000,1,1,1,3,2,1,4,7,0,0,0,0
2019-01-07 19:34:38.068000,1,2,2,5,1,1,2,4,0,0,1,1
2019-01-07 19:34:43.277000,3,1,3,7,2,0,2,4,0,0,0,0
2019-01-07 19:34:48.360000,0,0,2,2,3,2,1,6,0,0,2,2
2019-01-07 19:34:53.415000,4,0,2,6,2,2,2,6,0,0,0,0
2019-01-07 19:34:58.470000,1,1,1,3,2,0,2,4,0,0,0,0
2019-01-07 19:35:03.987000,0,1,4,5,4,1,1,6,0,0,2,2
2019-01-07 19:35:09.199000,2,2,1,5,2,1,3,6,0,0,1,1
2019-01-07 19:35:14.801000,6,0,1,7,2,0,3,5,0,0,1,1
2019-01-07 19:35:20.407000,0,2,3,5,1,1,0,2,0,0,0,0
2019-01-07 19:35:25.506000,2,0,3,5,1,0,4,5,0,0,0,0
2019-01-07 19:35:31.942000,0,0,3,3,2,0,2,4,0,0,1,1
2019-01-07 19:35:36.988000,0,1,0,1,4,2,5,11,0,0,0,0
2019-01-07 19:35:42.750000,1,0,3,4,1,0,2,3,0,0,0,0
2019-01-07 19:35:48.342000,0,0,2,2,2,1,3,6,0,0,0,0
2019-01-07 19:35:53.798000,6,0,1,7,3,1,7,11,0,0,0,0
2019-01-07 19:35:58.938000,1,1,4,6,3,3,0,6,0,0,1,1
2019-01-07 19:36:04.616000,2,1,1,4,2,0,3,5,0,0,1,1
2019-01-07 19:36:09.895000,0,0,3,3,1,2,4,7,0,0,2,2
2019-01-07 19:36:16.880000,3,0,4,7,2,2,5,9,0,0,1,1
2019-01-07 19:36:22.052000,2,0,1,3,1,1,4,6,0,0,0,0
2019-01-07 19:36:27.132000,3,0,2,5,3,3,2,8,0,0,1,1
2019-01-07 19:36:32.627000,1,1,2,4,1,0,1,2,0,0,0,0
2019-01-07 19:36:37.688000,2,1,3,6,3,0,3,6,0,0,1,1
2019-01-07 19:36:42.691000,1,4,4,9,1,1,4,6,0,0,0,0
2019-01-07 19:36:48.366000,0,0,1,1,2,1,4,7,0,0,1,1
2019-01-07 19:36:53.440000,1,1,4,6,1,2,6,9,0,0,1,1
2019-01-07 19:36:59.845000,2,1,0,3,1,2,3,6,0,0,2,2
2019-01-07 19:37:05.738000,1,0,2,3,4,0,5,9,0,0,2,2
2019-01-07 19:37:10.766000,0,1,2,3,1,0,4,5,0,0,0,0
2019-01-07 19:37:15.856000,1,0,0,1,4,0,3,7,0,0,0,0
2019-01-07 19:37:21.832000,0,1,1,2,1,0,3,4,0,0,0,0
2019-01-07 19:37:27.289000,0,1,4,5,2,1,3,6,0,0,0,0
2019-01-07 19:37:32.292000,3,0,0,3,6,0,5,11,0,0,1,1
2019-01-07 19:37:37.521000,2,0,4,6,3,1,4,8,0,0,2,2
2019-01-07 19:37:43.322000,0,1,2,3,4,2,5,11,0,0,0,0
2019-01-07 19:37:50.363000,1,1,3,5,4,1,2,7,0,0,1,1
2019-01-07 19:37:56.047000,3,1,3,7,2,4,5,11,0,0,1,1
2019-01-07 19:38:01.070000,2,1,2,5,5,1,1,7,0,0,0,0
2019-01-07 19:38:07.144000,2,0,1,3,0,1,6,7,0,0,1,1
2019-01-07 19:38:13.303000,1,0,6,7,7,3,3,13,0,0,2,2
2019-01-07 19:38:18.500000,2,0,2,4,0,1,1,2,0,0,0,0
2019-01-07 19:38:24.086000,1,1,3,5,1,0,5,6,0,0,0,0
2019-01-07 19:38:29.587000,2,1,4,7,1,1,2,4,0,0,2,2
2019-01-07 19:38:34.786000,0,0,3,3,3,1,4,8,0,0,1,1
2019-01-07 19:38:39.796000,1,0,3,4,1,0,2,3,0,0,0,0
2019-01-07 19:38:44.848000,1,0,5,6,1,0,1,2,0,0,0,0
2019-01-07 19:38:50.125000,4,1,5,10,1,1,2,4,0,0,1,1
2019-01-07 19:38:55.143000,1,1,1,3,2,2,2,6,0,0,1,1
2019-01-07 19:39:00.230000,1,1,2,4,1,1,3,5,0,0,0,0
2019-01-07 19:39:05.874000,2,0,2,4,4,0,4,8,0,0,0,0
2019-01-07 19:39:11.009000,0,1,3,4,1,1,4,6,0,0,0,0
2019-01-07 19:39:17.085000,0,1,2,3,2,1,2,5,0,0,1,1
2019-01-07 19:39:22.298000,2,0,1,3,4,1,3,8,0,0,0,0
2019-01-07 19:39:28.171000,1,0,1,2,7,1,4,12,0,0,1,1
2019-01-07 19:39:33.339000,2,0,2,4,3,2,3,8,0,0,0,0
